матроса: срамота, 
мигнули: мигулин, 
кропает: проекта, 
чисел: числе, 
стиле: стели, лести, листе, 
потушила: пошутила, 
выдавали: выдавила, видывала, 
мерин: мирен, ремни, 
мичен: ничем, 
оставленное: основателен, 
кустень: стеньку, 
дрожали: рождали, 
лазила: залила, 
симме: месим, 
собрал: бросал, 
месси: смеси, 
семит: мести, 
мерит: ритме, митре, 
местечек: местечке, 
отсвечивали: величавости, 
прелата: трепала, 
кюрие: юркие, 
сетки: кисет, истек, 
кисея: сякие, 
тетки: тките, 
сепик: песик, пески, 
пешки: пикше, 
вероятности: островитяне, 
креси: риске, 
терки: крите, 
сказан: канзас, 
женоград: огражден, 
лакауз: указал, 
дожде: одежд, 
смели: месил, 
милое: имело, 
учту: тучу, 
перил: прели, 
сипел: спели, 
петли: плите, плети, 
шипел: шпиле, плеши, 
терли: литер, трели, 
мишле: шмели, 
силен: синел, несли, 
ценил: линце, 
затопали: затопила, 
устраняли: растянули, 
василья: явилась, 
песий: испей, 
насобирал: набросила, набросали, 
трусится: струится, 
закату: закута, 
припомнила: припоминал, 
мишке: мишек, мешки, 
кинет: нитке, 
прилетало: пролетали, 
поминались: понимались, 
клери: рекли, 
силке: секли, 
телик: килте, телки, текли, 
елико: колеи, 
лепки: кипел, пекли, 
клише: кишел, 
щелки: клещи, 
расцвет: царстве, 
секим: миске, 
никем: неким, кинем, 
забрались: разбилась, 
здоровались: разводилось, 
бросовым: выбросом, 
властию: сливают, 
сероватых: страховые, 
горб: гроб, 
шиворот: ворошит, 
игбо: боги, 
антилопа: натопила, 
заговорит: развитого, 
провалялся: прославляя, 
проводи: породив, 
бегу: убег, губе, 
греб: брег, герб, берг, 
гибе: беги, 
воцарился: яслирацов, 
заспорили: запросили, 
конченый: конечный, 
материалов: отмеривала, 
камзол: замолк, 
вспухшие: успевших, 
раскинул: рисканул, рискнула, 
подвигла: погладив, 
дубы: дыбу, 
дубу: буду, 
египте: египет, 
обод: одоб, 
добр: бодр, брод, 
полпути: потупил, 
дубл: блуд, 
ножом: можно, 
выиграл: игрывал, 
дубе: беду, буде, 
боде: обед, 
берд: бред, 
ступая: пустая, 
ответим: отметив, 
судов: своду, 
рядов: ярдов, 
духов: входу, 
антоний: антиной, 
повидать: подавить, 
кресел: кресле, 
работам: абортам, 
стекле: скелет, 
выход: выдох, входы, 
простил: стропил, 
взаперти: запретив, 
приемов: поверим, 
закром: зраком, 
родов: одров, 
покинула: понукали, 
проникал: проникла, 
эреб: брэе, 
беру: буре, 
поручил: проучил, упрочил, 
обер: боре, 
бену: небу, 
небо: боен, 
тесную: суетню, 
бело: боле, 
дежурство: рождеству, 
обдутой: обойдут, 
довесок: седоков, 
бозе: безо, 
возвода: заводов, 
проходили: приходило, 
комете: меткое, 
остановки: сотникова, 
надзора: роздана, 
подрасту: простуда, 
бревен: бревне, 
растением: интересам, 
алешкой: шейлока, 
запаху: паузах, 
бертоне: обернет, 
зяби: бязи, 
пошутил: полтуши, потушил, 
кротового: отговорок, 
тилберг: гилберт, 
авторском: островкам, 
тележки: жилетке, 
укрыл: крылу, 
музыкант: замкнуты, 
стокера: корсета, сектора, кортеса, красоте, 
груши: гришу, 
стану: насту, 
боли: било, либо, 
завидев: изведав, 
занимало: анализом, 
строже: сожрет, 
утопают: опутают, 
вонмите: отменив, 
молвила: миловал, 
грудой: другой, 
ниггер: геринг, 
ревкому: куревом, 
отвалил: отливал, 
повалил: поливал, 
законен: казенно, 
спортится: простится, 
смогло: слогом, 
биту: убит, 
бури: руби, 
заливавший: заваливший, 
дядюшек: дядюшке, 
уступить: упустить, 
транс: стран, 
воронежа: оранжево, 
обратили: отбирали, 
резаком: закроем, 
кармен: кернам, крамен, 
различает: зачертила, 
приминали: принимали, 
разрешила: разрешали, 
волнами: малинов, миновал, 
колос: сокол, 
клопы: пылко, 
полку: купол, 
словами: символа, 
знавать: назвать, 
стенка: станке, 
наутек: утенка, 
долив: водил, 
видом: двоим, 
видно: дивно, 
входи: двоих, 
узнавая: увязана, 
видны: двины, 
пробором: пробормо, 
обротав: отобрав, 
пробует: потребу, 
обидела: обедали, 
окажется: жестокая, 
потрясал: потрясла, 
свиток: тисков, 
разлуке: зеркалу, 
колют: локтю, 
уклон: клоун, 
шаткое: окашет, 
нежадную: надежную, 
гонит: ногти, 
трясущиеся: струящиеся, 
паническим: песчинками, 
крестик: риккетс, 
стонам: станом, 
быку: кубы, 
парно: напор, 
обрыва: выбора, 
торна: трона, 
хорна: норах, 
обул: блоу, 
квинсборо: сборников, 
насос: сосна, 
фасон: сафон, 
сноха: ханос, 
нотах: тонах, 
видит: твиди, 
дожила: ожидал, 
шляпу: пляшу, 
копает: капоте, 
орешка: рекоша, 
юджина: дюжина, 
конвоем: военком, 
восходил: всходило, 
вожди: жидов, дожив, 
доставку: вудстока, 
бысть: сбыть, 
нарастает: тарантасе, 
устроен: нестору, 
уставали: усватали, 
анною: юнона, 
молльдопелуб: елоплодмульб, 
купера: упрека, 
аспект: степка, 
ломко: комол, колом, 
луком: умолк, 
поплинов: пополнив, 
невод: ендов, 
дворе: ведро, вроде, древо, 
словечек: словечке, 
наземные: заменены, 
детву: ведут, 
останкам: стаканом, 
девре: ведер, вреде, древе, верде, дерев, 
ударить: удирать, 
могли: могил, 
вниде: девин, дневи, виден, видне, 
верди: двери, 
выезд: взыде, 
сохранены: сохранные, 
девок: водке, 
сгнил: сигнл, 
гинул: гнули, глину, 
лонги: гнило, 
побеждал: подбежал, 
прогнал: проангл, 
довел: делов, 
ведом: медов, 
двоится: водится, 
глупи: плуги, 
плюсы: сыплю, 
сбыту: бутсы, 
бравую: бювару, 
актеры: ракеты, кареты, 
карету: актеру, 
распылили: присылали, 
правилу: управил, 
треска: креста, 
куреню: юнкеру, 
металла: маллета, 
даруя: радуя, 
рудах: дурах, 
напоминал: напомнила, 
конские: инкское, 
горки: игрок, 
кривском: вскриком, 
никог: гонки, инког, 
полетел: теплело, 
борю: бюро, 
убор: буро, бору, 
устрицы: цитрусы, 
стекая: кается, 
рождал: дрожал, 
вытирал: литавры, 
сновали: нависло, 
глубоко: голубок, 
ротацию: отрицаю, 
внушали: внушила, 
кормом: мокром, 
простила: пристало, растопил, стропила, 
просияла: опирался, 
проведенной: предвоенной, 
экономки: экономик, 
поручила: поручали, 
иглой: лигой, 
альбом: мольба, 
скатиться: скитаться, 
спрятать: стряпать, 
закроет: розетка, отрезка, 
полоснуло: ополоснул, 
солонки: носилок, 
побегами: погибаем, 
мудро: морду, дуром, 
оставил: отвисла, 
столице: целости, 
сорвали: рисовал, соврали, 
оконце: оценок, 
липовая: поливая, 
охватил: хватило, 
доложила: одолжила, 
дромы: морды, 
датою: отдаю, 
ядром: рядом, 
худом: духом, 
утенок: енотку, 
урода: уорда, 
родах: хорда, 
перестоять: потереться, 
барство: рабство, 
уводить: удвоить, 
покорные: покорены, 
близко: близок, 
отборные: обертоны, 
ама: маа, 
бла: лба, бал, 
боа: оба, або, 
раб: бар, бра, арб, 
авг: гав, 
два: дав, 
ева: аве, 
айв: вай, 
лав: вал, 
ван: нав, 
ова: аво, 
гад: даг, 
каг: гак, 
мга: гам, маг, 
ган: наг, 
гас: саг, 
ваш: вша, 
дал: лад, 
дам: мад, 
над: дан, дна, анд, 
рад: дар, 
аду: уда, 
ела: але, 
жар: раж, 
корк: крок, 
зал: лаз, зла, 
наз: зна, 
али: ила, 
буря: рубя, 
ина: ани, 
паи: пиа, 
ита: ати, 
рыбу: буры, 
айн: най, 
труб: брут, 
прибегал: прибегла, 
лак: кал, 
бледному: дубленом, 
пак: кап, 
акр: кар, рак, кра, 
акт: так, кат, 
кха: хак, 
мал: лам, 
ало: лао, 
пал: лап, 
тла: лат, 
нам: ман, 
тма: там, мат, 
ума: аум, 
мах: хам, мха, амх, 
аля: лая, 
топлива: оплатив, 
нар: ран, 
сна: нас, сан, 
нат: тан, 
правило: пролива, оправил, порвали, 
вспоила: совпали, повисла, 
чан: нач, 
наш: шан, 
яма: мая, 
сниматься: сминаться, 
аня: яна, ная, 
пар: пра, 
пас: сап, спа, пса, 
пах: хап, 
арт: рат, тра, рта, 
ура: ару, 
арч: чар, 
арш: шар, раш, 
юар: раю, 
яра: рая, 
аст: ста, 
соринки: росинки, 
очертил: чертило, 
ату: аут, 
шарфе: шафер, 
таю: юта, 
театр: трате, 
расея: серая, 
шах: хаш, 
изволил: изловил, 
бог: гоб, 
губ: буг, 
обе: бое, 
скул: слук, 
бил: бли, 
ибо: оби, бои, 
бок: коб, 
бук: куб, 
колы: лыко, 
эйб: бэй, 
лоск: скло, 
коул: колу, укол, 
блу: лбу, убл, 
был: лбы, 
быст: сбыт, 
тихоне: хитоне, 
приятная: принятая, 
бор: роб, 
осетин: отнеси, 
бур: руб, 
бюр: брю, 
тройку: туркой, крутой, 
облаве: обвела, 
скорый: крысой, 
буш: шуб, 
степа: спета, 
смутила: стимула, 
патер: петра, парте, 
посетил: постели, 
казенном: незнаком, 
ободрял: одобрял, 
насыпем: сыпанем, 
глянуть: лягнуть, 
гикори: игроки, 
вег: евг, 
логики: иголки, 
диаметре: мередита, 
дев: две, 
вез: зев, 
век: кев, 
лев: вел, 
вне: вен, 
ево: вое, 
евр: рев, вер, 
све: все, вес, сев, 
яве: вея, 
зов: воз, 
вии: иви, 
кви: вик, 
вяз: язв, 
кумя: ямку, 
ивы: выи, 
куму: муку, 
запряжке: запряжек, 
вон: нов, 
вор: ров, 
вот: тов, отв, 
мокр: корм, 
оком: комо, 
быту: тубы, 
перетак: паркете, 
шву: вшу, 
рдяно: родня, рядно, 
дурно: ронду, 
швы: выш, 
подоле: подлое, 
выя: явы, 
дохлое: холоде, 
матерно: монтера, ремонта, 
заливая: заявила, 
заварил: разлива, 
заливал: завалил, 
отменах: монетах, 
досель: делось, 
содеял: оделся, 
дег: где, 
год: дог, 
лагерем: гремела, 
затоплю: ползают, 
изг: зги, 
карпетки: практике, 
игл: лги, гли, лиг, 
иго: гои, 
игр: гри, 
обрели: олбери, 
оранжистов: насторожив, 
гук: куг, 
гол: лог, 
гул: луг, лгу, 
мог: гом, 
ног: гон, 
черному: речному, 
гну: нуг, 
опг: пог, гоп, 
гор: рог, огр, 
гур: гру, 
окно: окон, 
сцена: сенца, 
стена: тесна, 
ранец: ранце, 
никсону: соннику, 
терна: рента, 
пашне: пшена, 
залитому: замутило, 
псовой: воспой, 
нанес: сенан, 
ренан: ранен, 
вазелин: низвела, 
заверил: развели, верзила, разливе, 
зависел: заселив, ливазес, 
взимает: заметив, 
монтане: ментона, 
примерном: премирном, 
дел: лед, 
дне: ден, нед, 
ред: дер, 
танец: танце, цента, 
жид: джи, жди, 
тед: дет, 
изд: дзи, 
дин: дни, инд, 
оди: дио, 
иду: уди, 
облике: кобели, 
идя: яди, 
док: код, 
дом: мод, 
ляд: для, 
торговом: творогом, 
дон: дно, 
орд: род, 
бричке: бричек, 
откололись: колотилось, 
днэ: дэн, энд, 
суд: дус, 
ярд: ряд, 
коту: току, уток, 
дух: худ, 
ярко: ярок, кроя, 
откр: корт, 
окру: урок, укор, кору, 
прок: корп, 
разбив: избрав, 
шуткой: штукой, 
вонзает: назовет, 
кислов: сливок, силков, кловис, 
ценам: немца, 
манет: темна, намет, 
столами: малости, 
скалься: скалясь, 
утесы: суеты, 
чехам: мечах, 
монтану: туманно, 
незримы: резными, 
мечта: чатем, матче, 
схема: смеха, 
зле: лзе, лез, 
массе: месса, 
уже: ежу, 
храме: мерах, махер, 
мерса: марсе, 
артем: матер, метра, марте, 
ферма: марфе, 
ели: иле, 
еси: сие, 
кое: кео, оке, 
кер: рек, 
лео: оле, 
сел: лес, 
лет: тел, 
приказу: капризу, 
капризы: приказы, 
мне: нем, мен, 
мое: оме, 
сем: сме, 
ему: уме, 
цел: лец, 
наскрести: санскрите, 
нес: сне, сен, 
чем: меч, 
нея: яне, 
отравила: ратовали, 
пре: пер, 
каретник: картинке, 
рте: тер, 
епь: пье, 
ест: тес, 
мнози: низом, 
упорных: понурых, 
упорную: понурую, 
кристиан: старинки, 
измялась: замялись, 
тушим: шумит, 
имбирная: рябинами, 
бывали: выбила, 
нищеты: щетины, 
сбавил: сбивал, 
убивал: убавил, 
обивал: обвила, 
пенал: плена, плане, 
тлена: налет, лента, 
помнила: понимал, поманил, 
шлема: мешал, 
хиланом: лихоман, 
метал: летам, телам, 
смела: масел, лесам, масле, 
летал: тлела, 
криков: коврик, 
жертву: твержу, 
телах: летах, 
атлет: латте, 
сеяла: селая, 
селах: лесах, 
тесал: тесла, 
терла: талер, 
жил: лжи, 
ржи: жир, жри, 
плеча: плаче, пчела, 
слепа: спела, 
лепта: плате, тепла, 
осела: лаосе, 
нож: жно, 
уместно: тесному, смутное, 
излом: мозли, 
орегон: горное, 
стегно: согнет, 
куря: ярку, 
куру: руку, урук, 
курт: крут, турк, 
телка: текла, 
капле: пекла, палке, 
ласке: леска, алекс, скале, 
суку: укус, 
говорливы: выговорил, 
куст: стук, 
вылезла: вылезал, 
ригодоне: единорог, 
приматов: отправим, потравим, примотав, 
жеребец: жеребце, 
скачек: скачке, 
скосить: окстись, 
калеку: кулаке, 
обмакнул: колумбан, 
вырезал: вызрела, 
тачке: тачек, 
кассе: секса, 
аскет: сетка, 
отрогов: второго, 
речка: чарке, 
карше: решка, краше, 
карет: карте, актер, 
зои: изо, 
кричите: чертики, 
пачек: печка, пачке, 
пешка: шапке, 
исподом: посодим, 
обретут: отберут, 
неука: науке, 
зол: лоз, зло, 
пенка: пекан, 
марке: камер, карем, рамке, рекам, ермак, мраке, крема, краем, 
семка: семак, маске, 
жмотина: таможни, 
макет: метка, матке, 
камне: немка, намек, 
шалек: шкале, шлаке, шелка, кашле, 
зор: роз, 
рифмы: фирмы, 
припустила: приступила, 
шашке: шашек, 
чашке: чашек, 
сиделке: селедки, 
неподвластное: подставленное, 
козни: низко, низок, 
низку: кузни, куинз, книзу, 
скинув: свинку, 
браков: крабов, барков, 
лекарь: ларьке, 
стекал: стекла, 
завесом: засевом, 
покрой: поркой, 
торопись: опросить, оспорить, 
кашлем: мешкал, 
лакеям: мелкая, 
казематы: замыкает, 
маклер: кармел, реклам, 
ловушек: ловушке, 
щетину: нищету, 
тоской: стойко, 
анколе: калено, колена, 
колеса: оскале, 
плеска: склепа, слепка, 
платке: каплет, плетка, 
айрес: рейса, 
или: лии, 
простоял: потрясло, 
земными: змеиным, 
приняты: приятны, 
инк: кин, ник, 
пик: кип, 
кир: икр, 
иск: кис, икс, 
шейна: нашей, 
саней: йенса, 
илл: лил, 
нил: лин, 
пил: лип, пли, 
лир: ирл, 
сил: лис, 
кирпичом: покричим, 
кит: тик, 
шик: киш, 
машей: мешай, 
яик: яки, 
ним: мни, 
майне: найме, 
мои: иом, 
мир: рим, 
тим: мит, 
фил: лиф, 
шли: шил, 
лия: яли, 
шайке: кашей, 
орбите: бритое, 
рио: ори, 
оси: сои, 
собери: борисе, 
при: рип, пир, 
исп: спи, 
тип: пит, 
рис: сир, 
три: рит, 
риф: фри, 
рич: чир, 
сти: ист, сит, 
уси: сиу, 
исх: сих, 
накрутите: турникета, 
сократа: красота, 
чит: чти, 
пыльно: полынь, 
чих: чхи, 
бывало: облавы, 
унести: суетни, 
просит: спорит, прости, 
лопнут: топнул, 
изловила: изволила, 
прижатое: пожирает, 
извлекла: завлекли, 
колумб: клубом, 
вседержитель: ьлетижредесв, 
собой: босой, 
тобой: отбой, 
кучу: учку, 
коротали: рокотали, 
уолсли: сулило, уоллис, 
прознать: пронзать, 
проулкам: полумрак, 
мой: йом, 
имела: амели, 
елани: линеа, 
алели: аллеи, 
карие: ерика, 
китае: итаке, икает, такие, 
хотим: тихом, 
рисом: морис, 
зияли: излия, 
тимор: мирто, троим, 
крестьянина: накрениться, 
отданием: донимает, 
освещения: освящение, 
разлуки: закурил, 
проехали: приехало, 
уснуть: сунуть, 
засевали: зависела, 
затевали: заливает, лизавета, 
привезла: разлепив, 
поступь: пустопь, 
бодрилась: дробилась, добрались, 
кол: олк, 
посуда: посаду, 
обликом: обломки, 
знаем: замен, 
лук: кул, 
секретно: крестное, 
сюртуки: рискуют, 
засел: слеза, 
ерзал: резал, зрела, 
кон: нок, 
момент: темном, 
кум: мук, 
тезка: затек, 
око: коо, 
окр: рок, кор, 
сок: кос, 
кто: окт, ток, кот, 
уок: коу, 
пук: куп, 
яко: коя, 
рук: кур, кру, 
кус: сук, 
тук: кут, 
источили: очистили, 
чук: куч, 
точеными: отечными, 
собрала: бросала, 
обратал: работал, 
морни: мирно, мирон, минор, 
носим: симон, 
минут: митун, 
мусин: минус, сниму, 
тусклого: лутского, 
средние: средине, 
мазурик: закурим, 
оторвана: рановато, 
улыбок: кобылу, 
лохмами: холмами, 
затыкал: затылка, 
мол: лом, 
лежал: желал, жалел, 
визитера: развитие, 
директора: кредитора, 
нул: лун, 
луговой: угловой, 
желай: жалей, 
лоу: оул, 
фло: олф, 
лежаи: ежила, 
тул: лут, 
опровергла: опровергал, 
миром: римом, 
томми: тимом, 
знатоки: зонтика, 
подбежавший: побеждавший, 
противнее: поверните, 
грохотал: отгрохал, 
жалею: желаю, 
жалея: желая, 
рвалось: словарь, 
уэлсли: эллису, 
передои: периоде, 
примерно: перрином, 
пеленой: нелепой, 
услужлива: услуживал, 
полочкам: почмокал, 
ром: мор, 
покосной: спокойно, 
том: мот, 
мяо: моя, 
порождал: подрожал, 
мус: сум, 
тму: тум, 
ямс: сям, 
гулкая: гуляка, 
мху: мух, 
кромку: курком, 
плетей: теплей, петлей, 
ранее: арене, 
крепили: реплики, 
принимая: приминая, 
диаметру: артемиду, 
бойлю: любой, 
придете: приедет, 
елейно: еленой, оленей, 
честная: счетная, 
выпустившим: выступившим, 
мизерным: незримым, 
оон: оно, 
сон: нос, 
тон: нот, 
ону: оун, 
опростали: построила, 
сын: сны, 
энс: нэс, 
нят: тня, 
галерей: лагерей, 
ломались: молилась, 
следом: седлом, 
пледом: подмел, 
рвением: времени, 
шериф: фишер, шифре, 
показан: напоказ, запонка, 
нья: янь, 
вступите: впустите, 
ложись: жилось, 
пор: про, 
ягнока: коняга, 
рос: сор, 
ореховым: хромовые, 
сот: сто, 
орт: рот, тор, 
ору: роу, 
роя: яро, 
что: точ, 
поманила: понимала, 
тою: юто, 
тоя: ято, 
ухо: оху, 
незримая: мизерная, 
понурая: упорная, 
млечного: ночлегом, 
испорчена: исчерпано, 
усталь: услать, 
степи: спите, 
лекарем: рекламе, 
трясущийся: струящийся, 
отживе: животе, 
свежим: смежив, 
пирре: перри, 
пирсе: перси, 
питер: терпи, трепи, 
стивене: висенте, 
законам: наказом, знакома, 
северин: иверсен, 
верните: вентери, терниев, 
вопросами: просовами, 
добавился: добивался, 
рэп: пэр, прэ, 
псу: суп, пус, 
выжали: выжила, 
пут: туп, 
избрать: разбить, 
пологом: помогло, 
версией: сейвери, 
краешке: краешек, 
пардуса: распаду, 
тегерана: реагента, 
прилежно: пролежни, 
ровно: норов, ворон, 
носов: основ, 
сынов: вынос, 
пролетает: трепетало, 
дознание: изданное, 
рту: тру, тур, 
писании: испании, 
ввоз: взво, 
смотру: трусом, 
шеями: имяше, 
поручить: проучить, 
речных: черных, 
спине: песни, пенис, 
хенри: хрени, 
согреть: горесть, 
осанку: конуса, 
хинен: хенни, 
сионе: осени, 
кантор: контра, картон, 
потемок: пометок, 
конкурентом: конкретному, 
унеси: усине, 
откроем: откорме, 
ясени: синея, 
тус: сту, уст, 
сыт: тыс, 
уэс: усэ, 
мором: ромом, 
натаном: монтана, 
перчатке: крепчает, 
ямсом: мясом, 
редис: среди, 
невелико: неловкие, 
венг: гнев, гвен, 
добрыя: обряды, 
заборами: образами, 
петрония: приятное, принятое, 
ранами: марина, 
пересечет: пересчете, 
иарлат: алтари, 
пихала: пахали, 
питала: лапита, пилата, 
тупей: путей, 
дрейф: фрейд, 
клопов: полков, 
котлов: толков, 
ползла: ползал, 
приводилось: проводились, 
правители: приливает, 
окропляет: проклятое, 
тух: хут, 
туч: чту, 
шут: туш, 
уют: тую, 
вход: вдох, 
блудница: дублинца, 
двор: дров, 
води: диво, 
диву: виду, 
поминай: понимай, 
помогал: помогла, галопом, 
обнимая: обминая, 
веду: деву, 
тарани: тирана, 
воде: двое, 
виде: веди, 
ромбиках: микробах, 
рдели: лидер, 
следи: сидел, 
медик: едким, 
треском: крестом, 
дымной: дойным, модный, 
седни: снеди, седин, 
закопали: показали, 
причинено: причинное, 
схватки: свитках, 
хоров: ворох, 
посторонней: построенной, 
плотин: липтон, 
сеткой: сектой, костей, стойке, 
свет: вест, 
рвет: врет, ветр, 
реву: веру, 
пущать: щупать, 
свое: овес, осев, сове, 
воет: твое, отве, 
овен: ноев, нево, воен, 
лево: воле, вело, 
ниве: вине, евин, 
камеристки: крестиками, 
вери: реви, 
киев: веки, вике, 
вели: илев, леви, 
налогом: логаном, монгола, 
увез: везу, 
вежи: живе, 
вере: веер, 
потном: понтом, 
ашанти: наташи, 
простояли: торопился, 
заступили: запустили, 
заснул: наслуз, 
законами: амазонки, 
кровати: виктора, 
шариков: воришка, 
плутни: липнут, 
матрона: артамон, 
монарха: романах, 
пахари: архипа, 
седле: седел, 
придачу: причуда, 
солей: сейло, лосей, 
живя: вяжи, 
живу: вижу, 
посидел: подсели, 
метой: темой, 
мерой: морей, 
пиджака: пиждака, 
папаньке: папенька, 
склонами: носилкам, 
нарекут: куранте, 
марфутки: фруктами, 
сражались: сжарилась, 
йорке: рекой, 
забирать: базарить, 
возу: зову, 
коней: некой, 
топора: ропота, отпора, 
рейку: курей, 
весят: светя, 
измененное: неизменное, 
полете: теплое, 
трикрат: трактир, 
идете: диете, едите, 
язвы: вязы, 
рождала: дрожала, 
подбежали: побеждали, 
меняться: смятенья, 
вишь: шивь, 
корсетам: матроске, 
скрипуче: прическу, 
лобзали: облизал, 
пустота: отступа, 
скрипеть: скрепить, 
капиталом: лопатками, 
овис: свои, 
воин: вони, вино, 
приставали: приставила, 
виля: явил, 
выли: вилы, 
воли: лови, олив, 
впил: влип, 
слив: свил, 
трепом: помрет, петром, 
влил: вилл, 
хороша: шороха, 
непокорные: покоренные, 
чистоте: сочтите, 
спелые: слепые, 
ревут: ветру, 
вертя: верят, 
ветры: вытер, 
перечит: притече, 
приятный: принятый, 
показала: закопала, 
отказала: затакало, 
кастера: раскате, 
вляпался: сплавляя, 
отворится: воротится, 
собратья: обратясь, 
покамест: аспектом, 
просияв: восприя, 
цитата: тацита, 
чеснока: сонечка, 
прохода: пароход, 
накроет: картоне, 
утянет: тетуня, 
спротив: спиртов, 
непросто: построен, 
обратим: торбами, бортами, 
избрали: разбили, 
порочные: чопорные, 
темнел: летнем, 
прошило: порошил, 
опросил: просило, поросли, 
торопил: портило, пролито, 
развалился: разливался, 
тучные: учтены, 
кончена: чеканно, 
вынес: весны, 
случались: случилась, 
отберет: обретет, 
яков: вояк, 
горман: морган, рангом, 
скво: воск, 
воля: вяло, ловя, 
покоряла: акрополя, 
полнее: нелепо, 
повес: посев, 
нелепы: лепные, пелены, 
своре: серов, 
совет: отсев, отвес, 
чрево: вечор, 
постулат: отступал, 
воюет: твоею, 
входов: вдохов, 
вилять: влиять, вялить, 
сороке: скорое, 
влияют: виляют, 
упсале: успела, 
подурнела: подернула, 
оправой: паровой, 
бодрое: бороде, доброе, 
протопить: попортить, 
седлать: сделать, 
всему: сумев, 
бодрые: деборы, добрые, 
поэтам: этапом, 
обряде: добрея, 
промах: храпом, прахом, 
сточные: сочтены, 
сигаретном: негритосам, 
чуять: чутья, 
вердиктом: дмитровке, 
хранения: ранениях, 
верно: ровне, ровен, 
серников: ровесник, 
нервы: верны, 
веселятся: вселяется, 
апреля: прелая, 
трепал: прелат, 
атепину: паутине, 
проект: тропке, 
роковой: коровой, 
вопле: повел, 
слове: весло, лесов, слоев, 
втерся: рвется, 
волею: левою, 
вялое: веяло, 
версты: стервы, 
массор: ссорам, 
матрос: смотра, старом, 
явно: янов, 
чиновников: овчинников, 
ново: воно, онов, 
снов: свон, 
весом: севом, своем, 
одолжи: доложи, 
чресла: серчал, 
буграх: грубах, 
старел: стрела, 
ненужными: униженным, 
забавно: базанов, 
обливалась: обвалилась, 
конве: венок, 
ковер: крове, 
сверк: сквер, 
повертел: пролетев, 
помолчи: помочил, 
входом: вдохом, 
осмовд: сводом, 
тыкве: вытек, 
станине: тенниса, синнета, нанести, 
воют: твою, 
овсы: совы, 
ство: вост, 
сову: усов, 
джулии: луиджи, 
гранитные: аргентины, 
совр: ворс, 
ртов: втор, 
левом: молве, 
навсикаю: вакансию, 
навсикая: вакансия, 
волен: волне, 
анчутка: тачанку, 
вымел: левым, 
прометея: потеряем, 
зеркалами: закемарил, 
покойнику: упокойник, 
слитого: голосит, 
левой: волей, 
войне: веной, 
вехой: хвоей, 
омутах: хомута, 
подсела: последа, 
пошутить: потушить, 
урвать: утварь, 
росса: ссора, 
сорта: роста, остра, старо, торса, 
торфа: форта, 
жидкой: кийждо, 
обильным: больными, 
боооооог: гооооооб, 
верхи: вихре, 
решив: верши, 
чуткое: кочует, 
свите: весит, вести, 
будьте: будеть, 
косом: соком, 
приступили: припустили, 
наборов: баронов, оборван, 
пролегал: пролегла, 
забирали: базарили, 
венки: веник, кевин, 
ветки: витке, 
велик: вилке, квели, 
верил: ливер, 
весил: висел, свели, 
веяли: велия, 
ивенс: свени, синев, 
попас: попса, 
взводе: воздев, 
спора: проса, 
порта: тропа, 
порах: хопра, 
поста: стопа, 
обману: наобум, 
топча: почта, 
ушком: шумок, 
пальтишке: платьишке, 
наррангасетта: наррагансетта, 
подбегал: подбегла, 
котом: током, моток, токмо, 
квотами: активом, 
моряк: ярком, 
рыком: мокры, 
мысок: космы, косым, 
отвез: зовет, 
резво: взоре, 
кувшина: нашивку, 
чопорный: порочный, 
оправдал: продавал, 
раскосыми: комиссары, 
даровало: радовало, 
милость: сломить, 
молится: томился, 
коэном: эконом, 
возке: зевок, 
возле: зевло, везло, 
косным: сынком, 
звоне: звено, возне, 
уничтожила: уничтожали, 
отправить: потравить, 
братом: бортам, 
возникал: возникла, 
нестерпимо: посмирнеет, 
виконта: активно, 
чекунов: ночевку, 
проговорив: приговоров, 
покатой: патокой, 
стекала: ласкает, 
колодце: колодец, 
кортес: корсет, костер, строке, костре, скроет, окрест, 
наклепа: напекла, 
фиалка: калифа, 
спиной: псиной, 
мулы: мылу, 
омыл: мыло, 
смол: слом, 
курточка: карточку, 
пикалов: покивал, 
сковали: оскалив, 
посинел: понесли, 
вакулин: кивнула, 
венце: венец, 
севен: весне, 
растянет: натрясет, 
клеймо: мелкой, 
лавочки: ловкачи, 
попросить: поспорить, 
вечер: чреве, 
ветер: ревет, ветре, 
суета: утеса, 
калитвы: выкатил, 
потерпишь: прошипеть, 
торчевых: чертовых, 
милата: талами, 
махали: милаха, 
милана: манила, 
палами: лапами, 
лианах: хилана, 
лапина: напали, 
везем: змеев, 
хрястнул: стряхнул, 
налила: ниалла, 
обмякло: яблоком, 
сьюзи: сизью, 
догорает: геродота, 
нуль: лунь, 
африка: фиакра, 
исторгал: гастроли, 
ухает: утеха, 
антирес: старине, 
протеем: помрете, 
невинности: интенсивно, 
приюта: партию, 
скудному: сундуком, 
пиастр: спирта, патрис, 
дрожавшего: рождавшего, 
полотна: полнота, 
назову: навозу, 
кайноу: наукой, 
момента: наметом, 
гонок: конго, 
преступи: приступе, 
карточек: карточке, 
добавил: добивал, 
самкой: маской, 
ушло: уолш, 
хоул: олух, 
толю: люто, 
слоя: лося, 
соль: лось, 
дорогое: огороде, 
рыло: орлы, 
опля: поля, 
хлоп: плох, 
плот: толп, 
стручок: строчку, 
обыскал: колбасы, 
булочка: балочку, 
грабил: грабли, 
перекрестил: перестрелки, 
мягко: мягок, 
бумаги: губами, 
послали: слопали, 
бросалось: собралось, 
тройка: картой, 
свалился: сливался, славился, 
благородна: благодарно, 
яблочка: болячка, 
крылечек: крылечке, 
окошкам: кошаком, 
трибуны: турбины, 
монолога: ломаного, 
обедне: бедное, 
хлюп: плюх, 
мерзко: резком, 
пылу: пулы, 
добрее: бодрее, 
плюс: сплю, 
овладело: одолевал, 
символ: сломив, 
молитв: молвит, 
бодрого: доброго, 
расступилась: расступались, 
прожила: пожирал, 
уортинга: рогатину, 
горниста: органист, 
бедуин: будние, 
бредни: бренди, биндер, 
горечь: горьче, 
чадушко: дочушка, 
ротозеев: розовеет, 
полведра: проделав, продевал, 
потише: опишет, 
облаком: обломка, 
жрать: ржать, 
уволил: уловил, 
остряки: яркости, 
родют: тюдор, 
ремесле: ремесел, 
инкской: конский, 
пущего: погуще, 
отделилась: отделались, 
широте: ерошит, 
утолив: уволит, 
варежку: кружева, 
визжала: заважил, 
конченым: конечным, 
старому: матросу, 
страхом: смотрах, 
халлея: аллеях, 
отливало: отвалило, 
роланде: леонард, 
донесла: оседлан, сделано, 
деланно: неладно, 
завернутого: грузноватое, 
обрывы: выборы, 
грабитель: гильберта, 
проплыли: пропылил, 
ледяная: наделяя, 
вторил: творил, литров, 
обрывом: выбором, 
конченом: конечном, 
вложена: влажное, 
плечам: плачем, 
пожевал: пожелав, пожалев, 
примолви: приливом, 
немало: лемона, малоне, 
поход: подох, 
ломает: отмела, 
практично: прикончат, 
прогулку: полукруг, 
апельсин: спаниель, пенилась, 
пожинает: понижает, 
сонлив: вносил, 
арабские: арабески, 
наелся: лесная, 
унесла: салуне, 
оседлал: соделал, сделало, 
налился: слиняла, 
острия: ярости, 
салоне: олсена, 
трости: строит, острит, 
презирал: прирезал, 
обалдели: обделила, 
углисто: угостил, 
понесете: потеснее, 
ракушкам: кармашку, 
истертым: стертыми, 
сломила: сломали, смалило, 
нестираной: настроений, 
сопела: лопеса, 
лопает: оплате, потела, полета, 
алторе: отерла, 
холера: лахоре, 
спрут: пруст, 
мажор: жаром, 
итонской: скотиной, 
полноту: потонул, полутон, 
подкову: поводку, 
порожние: пирожное, 
блюдец: блюдце, 
выльется: выселять, 
хутором: хромоту, 
зданий: задний, дизайн, 
кандзи: задник, 
директоров: кредиторов, 
смутил: стимул, 
одобрил: бродило, 
найденным: надменный, 
сужал: служа, 
прогнию: пригоню, 
обнимаете: необитаем, 
собакам: баскома, 
витязе: взятие, 
лозой: золой, 
отменили: томлении, 
возите: зовите, отвези, 
привлекла: привлекал, 
извели: лезвии, 
марушек: марушке, 
требуха: бертуха, 
уздечек: уздечке, 
кончались: кончилась, 
гондолы: голодны, 
кружа: кражу, 
смогла: слогам, гласом, 
освещается: совещается, 
рожак: жарко, рожка, 
тугеле: телегу, 
ножка: жонка, 
черным: речным, 
ложка: жалко, 
облаках: бокалах, 
балканы: бакланы, 
забористое: сообразите, 
делилась: делались, 
наседал: сделана, 
чужак: жучка, 
долетали: отделали, отделила, 
вербой: бровей, 
труде: дерут, 
среду: сдеру, 
секрет: треске, кресте, 
оперетты: потертые, 
порожки: пирожок, 
рожай: жарой, 
заступить: запустить, 
бессчетных: бесчестных, 
гласно: согнал, 
повадок: подкова, поводка, 
беспокоило: обеспокоил, 
шагнул: шлангу, 
спину: псину, 
генералах: архангеле, 
христиан: христина, 
пинту: путин, 
промасленную: посрамленную, 
самотек: тесаком, 
пометка: пакетом, 
пощечины: почищены, 
загоном: газоном, 
робко: робок, 
бородавки: дробовика, 
нажим: нажми, 
жрали: жарил, ржали, 
искаж: скажи, 
укажи: ужаки, 
жинка: кажин, ажник, 
заменяли: изменяла, 
жалки: клажи, жилка, 
разлив: взирал, 
вязали: заявил, 
нэнси: эннис, 
галопу: пугало, 
томные: немоты, отмены, монеты, 
монету: мутное, отмену, 
грешен: шеренг, 
дурными: мундиры, 
смешно: смешон, 
тронем: ремонт, терном, ментор, 
выходом: выдохом, 
предана: пандера, 
педанта: нападет, 
разжала: заржала, 
тираж: жарит, 
сотни: остин, стони, носит, 
обыск: боксы, 
салунов: условна, 
боксу: скобу, сбоку, 
педро: допер, предо, 
волосан: салонов, основал, 
чопорна: порочна, 
нищетой: щетиной, 
уходе: худое, 
одеты: отыде, 
перекос: просеке, 
терпкое: проекте, 
минуло: умилно, 
поясной: оспяной, 
чумные: ученым, 
детогуб: добегут, 
упорной: понурой, 
запоров: паровоз, 
пожирала: поражали, 
отпустив: отступив, 
отправит: потратив, 
выборе: обрыве, 
отрока: торока, 
снедь: днесь, 
покато: потока, 
красноармейцев: краснорамейцев, 
голосисто: слоистого, 
схватилась: хвастались, 
боевых: быхове, 
сонин: сонни, 
донце: донец, 
дорен: недро, орден, родне, 
санитар: старина, 
невозм: звеном, 
сморил: лисмор, 
артура: траура, 
сломит: листом, 
молить: тольми, 
мутило: утомил, 
умолчи: мучило, 
лихому: хилому, 
звонка: знаков, 
злаков: вокзал, 
полями: помяли, 
отряхнул: тряхнуло, 
совещаются: освещаются, 
капоты: покаты, копыта, 
пахнуть: хапнуть, 
уровню: ровную, 
отделанную: отдаленную, 
тропка: прокат, 
дурачок: дурочка, 
помочник: покончим, 
добивались: добавились, 
домен: недом, медно, демон, 
добавила: обдавали, 
тедом: метод, 
загреб: разбег, 
благие: бегали, 
пронизал: пронзила, пронзали, признало, 
станицей: станцией, 
дремно: дерном, 
модные: демоны, 
благое: обегал, 
бугаем: бумаге, 
позвал: залпов, 
завяло: вязало, 
гуди: дуги, 
примял: прямил, 
лиловых: выхолил, 
увязла: увязал, 
мнется: сменят, 
связал: звался, 
снежком: женском, 
клубы: былку, 
допел: подле, 
седлу: следу, 
маккой: койкам, 
посадку: допуска, 
красою: кюрасо, 
сократ: кастор, костра, строка, красот, 
следя: делся, 
чернозема: размечено, 
звякая: вязкая, 
остришь: строишь, 
отвезу: зевоту, 
методы: одетым, 
торопливо: поворотил, 
горе: егор, 
огне: него, ноге, 
мостики: мистико, 
гире: игре, 
гиен: иген, 
гнилой: глиной, 
рейсы: серый, 
дочке: дочек, 
седок: доске, 
докер: редок, кредо, редко, декор, 
палкой: лапкой, 
скалой: лаской, 
цедилась: сидельца, 
суров: свору, 
отрыв: рвоты, 
рвоту: туров, 
ледок: лодке, 
творю: юртов, 
вторя: творя, 
лодочник: докончил, 
чистила: считали, частили, 
меняет: темнея, 
неучем: нечему, 
пришло: прошли, 
просил: спорил, 
одобрительно: ободрительно, 
одержал: держало, 
штуке: шутке, 
дорога: города, 
тетку: текут, 
мерное: номере, 
темное: немоте, 
измучила: замучили, 
острил: строил, 
старили: стирали, 
кусте: сетку, стуке, 
докажет: такожде, 
секты: стыке, 
ложечник: ночлежки, 
сучке: сучек, 
десерт: сдерет, 
сердце: сердец, 
коварно: воронка, 
высказался: сказывался, 
черткова: чертовка, 
потерянный: неопрятный, 
крохотные: некоторых, 
игру: угри, 
клинку: кликну, 
кликом: колким, 
гори: роги, 
топоров: поворот, 
ринг: грин, 
ноги: огни, гони, 
купец: купце, цепку, 
пушке: пушек, 
печку: пучке, 
гоим: моги, 
лигу: луги, иглу, угли, 
книг: кинг, 
протянуть: отпрянуть, 
пастор: проста, спорта, 
риги: гири, 
настроен: странное, 
вытеснило: волнистые, 
командует: документа, 
прироста: прорасти, 
жилкам: жалким, 
жаклин: кинжал, 
речку: круче, кучер, ручке, ручек, 
решку: шкуре, 
наброски: сборника, 
треск: крест, 
воспитать: поставить, 
оступился: опустился, 
мужика: жуками, 
качество: светочка, сваточек, 
норму: мунро, 
сыном: сонмы, 
добротные: недоброты, 
тоном: томно, 
криком: кромки, 
покатила: покатали, 
дюжин: юджин, 
кошер: кореш, 
кроче: очерк, 
яркое: якоре, корея, 
стоек: отсек, скоте, стоке, тоске, 
четок: четко, точке, кочет, точек, 
поточнее: почетное, 
туфлей: флейту, 
наговорили: оригиналов, 
снижал: жанлис, 
наносило: солонина, 
нахалка: каналах, 
упрек: крупе, купер, репку, 
развалиться: разливаться, 
учинилась: научились, 
пожали: пожила, 
мошну: шумно, 
озерцом: морозец, 
подвержен: поврежден, 
каринге: каргине, 
гликера: галерки, 
пластинку: пластунки, 
конце: конец, 
пахоты: опытах, 
отчисляли: отличился, 
выбор: обрыв, 
приводящим: провидящим, 
научили: учинила, 
подружке: подружек, 
пижаму: пижаум, 
войске: веской, 
порек: окреп, 
цепко: цепок, 
троек: кроет, 
анатолем: наломает, 
дожил: джоли, 
ошпарить: пошарить, 
авторские: строевика, 
продолжали: продолжила, 
повестка: аспектов, 
юбчонки: юбочник, 
гиллена: налегли, 
кошме: мешок, 
мочек: мочке, чеком, 
вытесняя: выясняет, 
угля: лягу, 
лугу: углу, 
корме: кроме, 
метко: комет, 
добрыми: бодрыми, 
плуг: глуп, 
кобуру: уборку, 
угол: логу, 
лэнг: нэгл, 
гнул: лгун, 
жирная: ржания, 
копне: копен, 
корне: норке, 
постороннем: построенном, 
назначали: назначила, 
гранате: гарнета, 
дорогами: городами, 
лещук: щелку, 
челку: чулке, 
отроку: укорот, рокоту, 
полке: пекло, 
отложенным: неотложным, 
лесок: леско, колес, 
текло: локте, лотке, котле, котел, колет, телок, 
млеко: мелко, колем, мелок, 
леску: скуле, 
летку: телку, 
плеск: склеп, 
пулек: купле, 
спирали: распили, 
гоня: огня, 
натуго: наготу, 
горн: ронг, 
гуно: ногу, угон, 
рождена: раждено, 
проезжали: приезжало, 
растянуть: устранять, 
кучке: кучек, 
высказалась: сказывалась, 
пробирает: прибратое, 
постукал: отпускал, 
кошке: кошек, 
кочке: кочек, 
дверец: дверце, 
подвижка: пиджаков, 
подушек: подушке, 
горт: грот, 
рогу: гору, 
коловейдин: ледниковой, 
ведено: ендове, 
вреден: древен, 
пропитавшееся: потрепавшиеся, 
вестовые: световые, 
понимаешь: поминаешь, 
овечкой: кочевой, 
церквой: йоркцев, 
ярдами: ядрами, рядами, 
мидасу: судами, 
нечестное: несчетное, 
синико: искони, 
подмоги: погодим, 
свиданки: всадники, 
нытики: никиты, 
смолкал: смолкла, 
умолкла: умолкал, 
обзеленю: любезное, 
табличке: табличек, 
невесомым: семеновым, 
жестами: сжимает, 
ордами: родами, 
вступивший: впустивший, 
околесил: колесило, 
вышиб: бывши, 
мойсел: смелой, 
дуновение: увиденное, 
доминго: догоним, 
поиски: описки, 
дворян: дворня, 
выбит: битвы, 
кушматской: кумшатской, 
разделила: разделали, 
отруби: орбиту, 
стальному: мотнулась, 
родина: народи, иордан, 
желания: лежания, 
обратились: отбирались, 
приминать: принимать, 
деланные: наделены, 
поттера: потерта, 
неладное: деланное, 
упустите: уступите, 
корпусе: просеку, 
поллса: послал, слопал, 
отделанное: отдаленное, 
барону: набору, убрано, 
точилась: читалось, 
обвил: облив, 
леннокса: склонена, 
огради: горади, 
гадину: дугина, 
испода: посади, 
обменивал: белавином, 
годами: догами, 
дигнам: мангид, дингам, 
искрит: стирки, кристи, 
холодина: находило, 
дивилась: давились, видались, 
разности: разносит, 
повидали: допивали, подавили, 
приладив: придавил, 
переврал: перервал, 
спиртом: простим, 
мому: умом, 
одежке: одежек, 
чековую: кочевую, 
дорогам: городам, 
констебля: столбняке, 
достать: отдасть, 
раздвоился: разводился, 
белов: обвел, 
шутейно: тушеной, 
брауну: буруна, рубану, 
путая: тупая, 
юном: мною, 
сонм: сном, 
норм: морн, 
воркует: уверток, 
минзом: мнозим, 
немыслима: маслеными, 
сотница: ностица, 
скатай: стайка, 
крестов: вскроет, сверток, 
гадюку: гадкую, 
неделя: деляне, леденя, 
курьера: карьеру, 
тираду: ударит, 
арктуре: рекрута, 
притопывает: пропитывает, 
христа: страхи, 
триста: артист, статир, 
трупа: парту, 
монголии: гомонили, 
кустом: стуком, 
неполнота: натоплено, 
исчерпывается: причесывается, 
счетной: честной, 
розетку: отрезку, 
облепившей: побелевший, 
мочу: моуч, 
пасть: спать, 
ярмо: яром, моря, 
юмор: морю, 
морт: ртом, 
кургашек: кургашке, 
голода: догола, 
карпушин: парнишку, 
витязь: язвить, 
женились: нежились, 
ленцой: цейлон, 
просватали: простаивал, 
слетясь: стелясь, 
начинали: начинила, 
добавили: добивали, 
отопру: отпору, 
ролики: лирико, 
опилки: копили, 
осилки: косили, 
кувырком: выкормку, 
куличи: лучики, училки, 
листик: слитки, листки, 
неразумия: разумения, 
маханул: махнула, 
замолвил: взломали, 
невыгодное: выеденного, 
крошево: орешков, 
живым: выжми, 
спелой: слепой, соплей, 
глазела: залегла, 
придолеет: определит, 
соколик: осколки, косилок, 
вложи: лживо, 
округ: горку, гурко, 
разливом: развилом, 
капризного: приказного, 
розочке: розочек, 
крону: кроун, 
рывком: крымов, 
поверку: упреков, 
нырок: кроны, рынок, 
москву: вкусом, 
конус: сукно, носку, 
косны: сынок, 
кормов: ковром, 
ужинает: унижает, 
ночку: кончу, 
подпустила: подступила, подступали, 
корон: норок, 
тонок: тонко, 
купно: купон, копну, 
трусит: турист, 
возку: кузов, 
рискуем: сумерки, 
развитием: визитерам, 
вязок: вязко, 
боярышкин: боярышник, 
гахнули: хулиган, 
сигналу: сиганул, сгинула, 
роботом: отбором, обормот, 
погнали: поганил, 
траур: артур, 
пролетам: полметра, 
скопом: компос, 
укором: уроком, 
кротом: откорм, 
скором: сроком, 
скотом: мосток, 
космос: соском, 
законом: знакомо, 
антиресу: нарисует, 
расценит: странице, 
алчному: молчуна, 
уоркс: сурок, сроку, 
круто: турок, 
мысу: сыму, сумы, 
сплетен: сплетне, 
ветерок: векторе, 
стум: смут, 
барского: рабского, 
уровнем: верному, 
ставит: твиста, 
отломив: отливом, 
получила: получали, 
гибернии: берингии, 
вестовых: световых, 
полилась: лопались, 
рогатил: трогали, 
грохали: олигарх, 
погасил: погасли, 
боксер: броске, 
уорбек: уборке, 
пыток: копыт, 
почку: пучок, 
мыть: тьмы, 
помазок: показом, 
проливается: постреливая, 
тиктаку: тактику, 
проку: купор, порку, 
топку: откуп, 
мутя: умят, 
тьму: муть, 
румянце: румянец, 
мешалось: сломаешь, 
логос: голос, 
сокровенного: кровеносного, 
ускачут: участку, 
жалмерке: желмерка, 
пометки: потемки, 
вязли: взяли, язвил, 
звони: низов, возни, 
морские: римское, 
уголь: ольгу, 
комитет: отметки, 
курсом: сурком, 
рыском: скорым, 
сигнуть: сгинуть, 
турком: крутом, 
моряку: яркому, 
потерянного: неопрятного, 
гортензио: горизонте, 
районам: майоран, 
чокот: точок, 
стянула: насулят, 
рокот: роток, отрок, 
скоро: сорок, 
ростепель: терпелось, 
бардом: бродам, 
пленены: пленные, 
наставила: настаивал, 
номера: романе, 
мрачен: мрачне, 
станем: стенам, 
трясущуюся: струящуюся, 
наделив: дневали, 
идеалов: одевали, 
продает: торпеда, 
моргали: громила, 
лингаму: мигнула, 
старилось: стиралось, строилась, 
отправился: провалится, 
тумане: мануте, 
затертое: отрезает, 
пришлось: прошлись, 
унялась: альянсу, 
соверменной: современной, 
плотнее: оплетен, 
ночевке: веночек, 
телесно: лестное, 
слоеные: соленые, 
ерзнул: резнул, 
оторвав: товаров, авторов, 
вредная: дверная, 
дореном: орденом, ормонде, 
мотает: отмета, 
табором: абортом, 
гулом: лугом, углом, 
голом: логом, могло, 
ликида: кидали, 
батенка: банкета, 
корсика: окраски, искорка, 
операм: проема, пароме, 
нирваны: равнины, 
прорезавшим: разопревшим, 
однолетнего: отделенного, 
постороннего: построенного, 
караковом: кормакова, 
шкаторину: картошину, 
обдать: бодать, 
наследными: сделанными, 
плечиком: покличем, 
вонзил: звонил, 
обряда: добрая, бодрая, 
адский: садкий, 
полетом: тополем, 
неразум: разумен, 
заморен: резонам, 
заметно: затемно, 
сливалась: свалилась, 
плетеная: нетеплая, пантелея, 
летником: клиентом, 
звонки: возник, 
атлантом: талантом, 
поведал: подвела, подвале, 
распустились: расступились, 
микадо: домика, 
гвинеей: евгений, 
растем: мастер, местра, 
дипломы: подлыми, 
качала: калача, 
михаила: малахии, 
пудры: пруды, 
пруду: пудру, 
пойнтера: трепаной, 
мартенов: намертво, 
золовки: изволок, 
разопревшие: прорезавшие, 
крайности: настройки, 
окадил: кадило, 
кустика: каустик, 
покоренного: непокорного, 
овладел: владело, 
пострадавшей: подраставшей, 
гнедая: ядгане, 
тильда: ладить, 
медовая: ведомая, 
приятного: принятого, 
сметая: мается, 
одарил: дарило, родила, 
подали: допила, 
ходила: охлади, 
ладоши: лошади, 
ударил: удрали, 
усадил: судила, 
ограде: драгое, 
укорять: рукоять, 
привалом: правилом, 
стирает: растите, триеста, 
телесная: населяет, 
отвалился: оставляли, 
обтерла: обретал, бартело, 
бросался: собрался, 
верстаке: сверкает, 
отчалить: отличать, 
атласа: салата, 
лидома: идолам, 
думали: дулами, мудила, 
данило: ладони, надоил, долина, 
дорену: ордену, дурное, 
доноре: родное, 
славились: сливались, свалились, 
молотить: отломить, 
отрасли: строила, 
проза: запор, 
винами: нивами, 
лесоруб: белорус, 
возродила: здоровила, 
влияет: виляет, 
листве: светил, 
силвер: сверил, 
привел: вперил, 
оливер: еоврил, 
левыми: вымели, 
зорок: зорко, 
продумали: придумало, 
пусты: ступы, 
значу: зачну, 
смолисто: слоистом, 
портила: потирал, пролита, 
ошпарил: пошарил, 
попарил: припало, попирал, пропали, 
утопила: утопали, 
почтила: почитал, 
разомкнуть: размокнуть, 
таврии: иврита, 
намерен: манерен, 
наливался: навалился, 
лишилась: лишались, 
измененная: неизменная, 
свинке: венски, 
ловкие: велико, 
свилке: кислев, 
вклеил: влекли, 
корками: каморки, 
хрястнула: стряхнула, 
прилипал: прилипла, 
новика: квиноа, 
маквис: вискам, 
логику: уголки, иголку, 
зонам: знамо, 
камушки: макушки, 
термос: строем, 
черного: огорчен, речного, 
вышине: вышние, 
выскребал: выскребла, 
отчалили: отличали, отличила, 
поедает: подаете, 
трактата: аттракта, 
просись: роспись, 
синевы: свиные, 
внести: виснет, стивен, 
домини: одними, 
насмешки: смешинка, 
свиное: осенив, 
дермотова: автодроме, 
просить: спорить, 
ученикам: мученика, 
кликало: окликал, 
клыками: калмыки, 
частило: источал, 
решилась: решались, 
алимов: волами, 
валило: ловила, 
сливал: свалил, 
ставил: свалит, власти, встали, листва, 
сочтем: счетом, 
бодена: надобе, 
привал: правил, 
выпила: выпали, 
вопила: полива, 
коротких: крохотки, 
витало: отлива, отвали, 
обедал: добела, 
хвалит: хватил, 
неудаче: удачнее, 
повесит: повести, посетив, 
поверит: порвите, 
сочти: чисто, 
считанный: станичный, 
передан: наперед, 
миннесоты: сотенными, 
неду: дену, дуне, 
думе: меду, муде, 
едом: доем, доме, моде, 
делу: удел, 
одел: доел, дело, доле, 
едок: коде, едко, 
дрей: рейд, 
идет: дети, дите, 
дверным: вредным, 
меди: идем, едим, 
леди: дели, 
дени: един, инде, иден, 
езди: диез, 
джем: ждем, 
горными: игорным, 
дене: неде, 
козам: замок, 
козла: лазок, 
указанном: наказному, 
скупая: пуская, 
терпит: претит, 
приюте: юпитер, 
горохом: хромого, 
троих: хитро, 
разок: зарок, 
ведомым: медовым, 
сократилась: раскатилось, 
дует: едут, теду, 
дусе: суде, 
ядер: ряде, ядре, 
руде: дуре, деру, 
реалисту: устарели, 
роде: одре, 
соде: досе, 
дефо: ефод, 
уснули: сунули, 
ивонна: наивно, 
кротко: кроток, 
дублинец: блуднице, 
пятном: помнят, 
удержав: державу, 
ханжами: нажимах, 
почти: чтопи, топчи, 
лампой: поймал, 
пости: сопит, 
проси: сироп, 
ретиво: ториев, 
секторах: корсетах, 
рудные: ерунды, дурные, 
кавана: канава, 
обидна: бидона, 
тинбад: бандит, 
савана: аванса, 
полустанке: потускнела, 
настигал: настигла, 
запри: приза, 
перечитаем: примечаете, 
втереться: вертеться, 
замри: зрима, 
коленом: неломок, 
зашли: зашил, 
лазил: залил, лизал, 
низал: знали, 
низка: знаки, казни, 
зраки: разки, 
медовых: ведомых, 
болты: отбыл, 
кормушек: кормушке, 
гуталина: лагутина, 
судити: студии, 
проявите: поветрия, 
оркестра: раскроет, 
правит: приват, 
идут: удит, 
суди: дуси, 
руди: дури, 
доит: тоди, 
водоемы: домовые, 
индо: один, одни, 
удим: муди, 
пожелаешь: пожалеешь, 
крошку: шкурок, 
удил: дули, 
идол: доил, доли, дило, 
сотням: снятом, 
горшки: грошик, 
округи: игроку, 
слепком: плеском, 
фактором: комфорта, 
превратило: проветрила, 
сгинет: сгниет, 
выпустят: выступят, 
регион: нигеро, 
речные: черные, 
укреплении: перекинули, 
которым: мокроты, 
тайни: найти, 
дикому: домику, 
стерне: теренс, 
китай: такий, 
капризами: приказами, 
дориана: иордана, 
чураться: ручаться, 
проулки: покурил, 
развить: взирать, 
обливы: выбило, 
покойничек: покойничке, 
покрыли: приколы, 
воронками: конвоирам, 
сопляки: копился, 
игеном: многие, 
окинул: кинуло, 
толкни: клонит, 
выпросишь: порывшись, 
ширинка: инишарк, 
уторах: хутора, 
напитки: антипки, 
стонать: отстань, 
отстану: саттону, 
армии: марии, 
тесные: сетные, 
повитый: выпитой, 
пятерка: терпкая, 
клиффорд: дроффилк, 
жалеет: желает, 
покосил: полоски, 
покорил: окропил, 
шутить: тушить, 
толико: толоки, колоти, 
содрать: радость, 
толику: улиток, 
скосил: скисло, 
слиток: листок, столик, 
дулю: люду, 
хлипко: хлопки, 
плоски: скопил, 
зверинце: зверинец, 
черное: речено, 
рогоносце: рогоносец, 
дуло: долу, 
пересекла: пересекал, перелеска, 
луговых: угловых, 
луговую: угловую, 
рокотом: котором, 
повлек: плевок, 
совлек: лесков, 
потомок: потоком, 
отбирая: обтирая, 
ерзает: тереза, 
замене: зееман, 
сытом: мосты, 
мосту: устом, 
караулки: каракули, 
думы: дыму, 
домы: моды, 
деревне: древнее, 
дому: моду, удом, 
отворить: воротить, 
продавались: оправдались, 
ушлет: лутше, 
пострадаем: подрастаем, 
ворошить: воротишь, 
телят: летят, 
дюны: дыню, 
спросонья: проносясь, 
стопку: отпуск, 
упряжек: упряжке, 
острове: ростове, 
нуды: дуны, 
привычек: привычке, 
кишками: микишка, 
карлики: клирика, 
доно: одно, 
одну: дону, 
доро: родо, 
внучке: внучек, 
пятясь: пяться, 
рукавом: кворума, 
отменены: отменные, 
комаров: коровам, 
мотовка: таковом, 
достигла: достигал, 
глазели: залегли, 
выпустил: выступил, 
прытко: покрыт, 
лепту: плуте, теплу, 
тепля: лепят, петля, 
пчелу: плечу, 
хрупок: хрупко, 
уход: ходу, худо, 
ласков: свалок, 
лукаво: уловка, вокалу, 
сход: сдох, 
орды: роды, одры, 
роуд: роду, урод, уорд, 
слепым: спелым, 
пенистым: степными, 
пакете: аптеке, 
передал: предела, 
грубы: бугры, 
заманить: занимать, 
карете: терека, ракете, 
полутора: полурота, 
погребла: пробегал, 
проросла: распорол, 
наделен: неладен, 
изваять: заявить, 
врывался: вырвался, 
потом: оптом, 
плечо: почел, 
тепло: полет, потел, толпе, 
лопес: слепо, ослеп, сопел, после, 
рисками: искрами, 
чехол: чехло, 
москва: квасом, 
мишкина: машинки, 
дыру: дуры, руды, 
дуру: руду, 
тисками: мистика, 
награду: драгуна, 
салотопы: апостолы, 
гребенские: кенисберге, 
трапезная: запретная, 
кресалом: расколем, 
стирать: растить, 
старухи: трусиха, 
копались: копилась, 
лампочке: лампочек, 
многим: гимном, 
ядры: ряды, 
коллис: локсли, 
оркестр: кротерс, 
клонил: коллин, 
качнув: внучка, 
еретическим: метрические, 
пустил: ступил, 
владение: давление, 
сяду: судя, 
деталей: делайте, 
развешенные: завершенные, 
бугор: грубо, гробу, горбу, 
выбрит: бритвы, 
вскоре: свекор, 
придавило: приводила, 
уродовать: орудовать, 
дивятся: видятся, 
сутках: кустах, 
визитка: завитки, 
гейтса: стегай, 
трепачка: перчатка, 
строчке: строчек, 
зависти: зависит, 
скрытое: корсеты, 
отрекся: кроется, 
лемур: рулем, 
нестроение: интересное, 
смело: лесом, слоем, 
летом: телом, омлет, 
рубашек: рубашке, 
медовые: ведомые, 
римской: мирской, 
дрожек: джокер, 
водопад: подвода, 
медсестер: медсестре, 
арапники: киприана, 
отвалить: отливать, 
представали: представила, 
кострам: строкам, 
морская: косарям, кромсая, 
храбро: харбор, 
кошмары: мошкары, 
довлеет: долетев, 
деловые: долевые, 
краска: каркас, 
надолго: ладного, гондола, 
поерзал: порезал, 
терзало: отрезал, 
созрела: розалес, срезало, 
работы: аборты, 
утроба: работу, 
залижет: изжелта, 
граммофона: фонограмма, 
историка: искариот, 
молился: ломился, 
манерах: хермана, 
составил: восстали, 
отломил: молотил, 
шутили: тушили, 
гришаку: игрушка, 
фигурка: графику, 
кругов: вокруг, 
тоны: ноты, 
тону: ноту, 
соня: нося, ясно, 
носу: сноу, 
нору: руно, урон, 
трон: норт, 
кальпа: альпак, 
плакат: платка, 
дружко: дружок, 
раскопали: покрасила, 
работке: обертка, 
скалам: маслак, 
кутала: латука, 
наглые: ангелы, 
занесло: заслоне, 
налоге: наглое, 
боронам: бароном, набором, 
караул: украла, 
развешала: завершала, 
неясный: сеянный, 
аляска: лаская, 
скатал: таскал, 
ласках: скалах, 
согласен: гонсалес, 
отбору: оботру, 
резнула: резанул, 
считая: чистая, 
считаю: частию, 
непрерывной: проверенный, 
докапываться: подкатываясь, 
обманут: табуном, 
темной: мотней, 
рваными: равными, 
ватными: выманит, 
точную: ночуют, 
обернув: брунове, бревноу, 
времечко: вечерком, 
покатом: потомка, потокам, капотом, 
дверные: вредные, 
замысел: замысле, 
марках: рамках, 
скатам: мастак, 
поправил: пропивал, 
отстраивал: стартовали, 
повалить: поливать, 
проявила: проливая, 
описывал: повысила, 
сипловат: воспитал, поставил, 
губил: глуби, 
сморкания: сорняками, 
ручонками: чукарином, 
деревни: древние, 
саперному: пасмурное, 
зовут: тузов, 
мнении: именин, 
возят: взято, 
канаты: накаты, 
науках: ханука, 
нуэр: эрну, 
призывом: призовым, 
ведении: видение, 
станка: стакан, 
сундуке: секунду, 
секунды: скудные, 
рукой: укрой, 
финикиец: инфекции, 
надуется: студеная, 
противясь: противься, 
чистота: отчасти, 
воротила: отворила, оторвали, 
раскатом: матроска, 
зараженной: зажаренной, 
стрелки: крестил, 
сакматов: мастаков, 
гилби: гибли, 
гармошки: горшками, 
распутал: расплату, 
стряпала: спрятала, 
уместны: смутные, суетным, 
призван: признав, 
грубом: бугром, 
гардена: награде, 
липкие: кипели, 
легион: голени, 
девушке: девушек, 
фонариком: микрофона, 
возом: зовом, 
растак: раскат, старка, 
реплику: укрепил, 
александер: александре, 
вспышке: вспышек, 
ведерок: ведерко, 
девочке: девочек, 
причесан: исчерпан, 
костыли: кислоты, отсылки, 
энту: нэту, 
мукой: мойку, 
пустят: ступят, 
иссякло: косился, 
кислоту: откусил, столику, 
мизерной: незримой, 
воронежу: вооружен, 
вылазки: взыкали, 
возками: зимовка, 
точку: чутко, 
пробиться: побриться, 
гришке: грешки, 
требуху: бертуху, 
шинели: лишние, 
горбе: гробе, 
восприняла: посравняли, понравился, 
антиноя: антония, 
матрасе: мастера, 
берег: гербе, 
яруса: русая, 
островом: ростовом, 
греби: регби, 
ускачешь: скучаешь, 
услуг: слугу, 
майчонки: чайником, 
намокший: машинкой, 
посекли: плоские, 
корпели: приколе, 
возля: взяло, 
бегло: блоге, 
португалии: погутарили, 
трута: трату, 
окрутил: укротил, 
моменту: темному, 
заломив: малоизв, изломав, замолви, 
гробом: горбом, 
позвали: завопил, 
изорвал: розлива, 
тоску: стоук, скоту, суток, 
звонила: вонзила, 
забора: образа, 
посмотри: построим, простоим, 
стукаясь: кусаться, 
ранено: нерона, 
умчались: мучилась, 
клиенту: теклину, 
отступу: пустоту, 
штурмовать: муштровать, 
набат: банта, 
пробился: побрился, 
абрам: амбар, 
нанеся: неясна, сенная, 
банка: кабан, 
краба: брака, барка, 
унижать: ужинать, 
чинов: овчин, 
оступе: пустое, 
лужине: неужли, 
веселят: светлея, 
зубрили: изрубил, 
осужден: суждено, 
ликером: мокрели, 
попросим: поспорим, 
таясь: аться, 
теплицы: петлицы, 
стивена: навести, 
урубом: бурому, 
остановку: установок, 
мотив: твоим, 
пивом: вопим, 
блестя: стебля, 
наступить: напустить, 
лобастую: абсолюту, 
пятку: купят, 
прикончим: кирпичном, 
туалете: улетает, 
рабами: арбами, 
провалившийся: проливавшийся, 
ловит: отлив, 
вопил: вопли, 
пенсах: наспех, 
родинками: родниками, 
свалила: сливала, 
наливал: навалил, 
добре: бедро, 
книжек: книжке, 
валенки: великан, 
невыносимо: освоенными, 
бедру: бреду, 
активен: вникает, 
бедер: бедре, 
ловли: ловил, 
дерби: дебри, 
вылил: виллы, 
вливалась: ввалилась, 
заселять: зальется, 
уместном: местному, 
волки: вилок, 
трансе: стране, тернса, стерна, 
токсины: скотины, 
натуре: трауне, унтера, 
кинув: икнув, внуки, 
полотенцами: потенциалом, 
историк: сиротки, 
скотину: сотнику, 
исков: висок, 
крови: криво, 
шоферам: шафером, 
притоков: тропиков, 
сивку: виску, 
вперила: привела, правиле, привале, 
аквинат: активна, 
арместо: арестом, 
светила: сливает, 
винюсь: свинью, 
метафор: формате, 
пьетро: потерь, 
потеря: протея, пятеро, 
потерю: протею, 
потрет: поттер, 
черная: речная, 
протер: портер, 
лучили: уличил, 
усилил: сулили, 
облака: бокала, 
заклевать: завлекать, 
проверенным: непрерывном, 
жуткие: кутежи, 
уладиться: удалиться, 
стежки: жестки, 
брехта: хребта, 
соринку: росинку, рисунок, 
сервиса: сиверса, 
сенцах: сценах, 
травина: вариант, наварит, 
виной: вийон, 
ремонтом: монтером, 
витой: войти, 
веселом: осмелев, 
тесная: сетная, 
сутане: сенату, 
половни: половин, 
рогатки: каторги, 
обнимает: обминает, 
подступили: подпустили, 
северными: сиреневым, 
называли: вылизана, 
заправил: призвала, 
букарем: кубарем, 
висли: сливи, 
влили: вилли, 
наварим: марвина, 
тугом: могут, 
покинут: потнику, 
зарывали: выразила, 
завались: завилась, 
трамваи: вратами, травами, 
старым: страмы, 
амбару: абраму, 
свити: стиви, висит, 
уступили: упустили, 
осмотрел: смотрело, 
племенам: пламенем, 
загоне: газоне, 
стадные: десанты, 
гумно: многу, 
газует: газету, 
много: гомон, 
плодитесь: последить, 
завалили: заливали, 
товарами: авторами, 
могикан: киганом, 
пародиен: приданое, 
поедания: подаяние, 
барона: набора, 
багровое: обогрева, 
устраняться: растянуться, 
примеров: проверим, 
убрана: брауна, 
исчислить: чистились, 
сиреневом: северином, всемирное, 
спустили: испустил, 
гитаре: играет, герати, 
нетерпения: неприятнее, 
цельными: мельницы, 
курагин: каргину, 
плотам: толпам, 
отмола: молота, мотало, 
пансиона: написано, 
одолжил: доложил, 
колебал: облекла, 
чередой: дочерей, 
робота: отбора, 
обрекал: корабле, 
соседу: сосуде, 
углями: милягу, 
шорох: хорош, 
могилы: голыми, 
халвой: хвалой, 
сантиметров: материнство, 
торос: остро, 
истца: ситца, 
части: чиста, 
саути: аисту, 
вредит: тверди, 
водите: отведи, 
климента: клиентам, летникам, теклинам, 
видное: дивное, 
дивные: видные, 
дверки: древки, 
стеклами: слетками, 
сразило: заросли, 
отдыхе: одетых, 
пятых: пыхтя, 
желе: леже, 
уголочке: уголочек, 
ропот: отпор, топор, 
опрос: порос, просо, споро, 
бежало: обежал, желоба, 
игроков: кривого, 
топос: посто, 
цифра: фрица, 
стира: расти, 
вышней: нывшей, 
крадуту: украдут, 
престола: постарел, 
ядреных: ядерных, 
ступать: спутать, 
подавился: повадился, 
мене: мнее, 
лете: теле, 
муже: жуем, 
лежу: луже, 
лжет: желт, 
хвойна: войнах, 
рваной: равной, нарвой, 
межи: имже, 
лежи: ежли, ежил, 
жени: ниже, 
заборе: образе, 
птахи: типах, 
потеряла: пролетая, 
рваный: равный, 
психа: пасхи, 
протянул: отпрянул, 
парит: пират, 
парис: пирса, 
хилого: лихого, 
заберу: арбузе, 
подавив: повидав, 
протягивали: притягивало, 
выдавил: видывал, 
блумер: рублем, 
волокна: коновал, 
бемоль: мольбе, 
жует: туже, 
древко: дверок, 
замолкал: замолкла, 
уступах: пастуху, 
жрет: ржет, 
исчерпал: причесал, 
женя: няже, 
неопрятных: потерянных, 
зеро: озер, 
коровника: раковинок, 
зоне: зное, 
антилоп: липтона, плотина, 
стеймер: смертей, 
райское: косарей, 
узел: лезу, узле, 
ракетой: каретой, 
злое: зело, золе, 
покается: копается, 
зиме: змеи, 
сигнул: сгинул, 
стонали: латинос, 
отлична: наточил, 
отблеск: блесток, 
склонен: леннокс, 
семушку: усмешку, 
скорбел: скребло, 
волоска: ласково, 
булочек: булочке, 
тронемся: несмотря, 
помахивал: похвалами, 
притоками: тропиками, 
чредою: дочерю, 
бразилия: изрябила, 
изрубила: зарубили, 
слазишь: зашлись, 
медово: ведомо, 
атлонский: латинской, 
пети: типе, 
вороном: норовом, 
тени: тине, 
шеин: нише, 
сени: сине, неси, инес, 
теми: мите, 
мифе: ефим, 
напущали: нащупали, 
бейрна: брайен, 
имен: мине, 
мире: риме, 
лещи: щели, 
шлеи: лише, 
если: силе, сели, 
рели: лире, 
лице: цели, 
имел: лиме, мели, миле, 
ерик: икре, реки, 
кепи: пике, 
лике: елки, 
саблей: слабей, 
скупают: пускают, 
бисквитов: вобисквит, 
пинта: антип, 
писан: псина, спина, 
фанни: финна, 
пускать: скупать, 
уступка: капусту, 
шинах: наших, нишах, 
проступил: пропустил, 
танти: титан, 
аунти: аниту, 
болеро: обрело, оробел, 
побрел: пробел, 
затаился: застилая, 
удирали: ударили, 
приводило: проводили, 
тише: теши, 
щите: ищет, тещи, 
заступил: запустил, 
одобрить: ободрить, 
осей: соей, 
пейн: пней, 
тлей: лейт, 
омахи: охами, 
маори: марио, 
коей: окей, 
лейк: клей, 
нашим: мишна, машин, 
писцы: спицы, 
бранда: данбар, 
нарушали: нарушила, 
масти: смита, миста, 
мария: армия, ярами, 
марию: армию, 
ширма: марши, 
оригеном: регионом, 
ритма: ртами, 
злому: узлом, 
директорам: кредиторам, 
морозе: озером, 
женили: нежили, 
следов: вослед, 
женихи: хижине, 
чеку: куче, 
высказали: сказывали, 
обрела: робела, 
дворце: дворец, 
кует: утке, 
совдеп: псевдо, подсев, 
провед: продев, 
секу: усек, 
керя: ярке, 
уровни: уронив, 
реку: руке, 
черк: керч, 
свалившийся: славившийся, сливавшийся, 
крен: керн, 
кеун: кену, 
коне: ноке, окне, 
лишила: лишали, 
матил: малти, 
ислам: силам, 
налили: лилиан, 
куме: муке, 
пилила: палили, 
емко: коем, 
ахилл: хилла, 
бахает: хабеат, 
салли: слали, слила, 
ниалл: налил, 
щелк: клещ, 
клеш: шелк, 
клер: рекл, 
личина: чинила, 
отворившись: воротившись, 
затухал: затухла, 
истлели: стелили, 
приятной: принятой, 
талия: лаяти, таяли, литая, 
лифта: талиф, 
числа: силач, 
алису: луиса, 
листа: стали, стила, 
несложные: сложенные, 
плащи: щипал, 
пасли: писал, спали, 
питал: пилат, лапти, плита, плати, палит, 
карими: икрами, 
опали: поила, 
нашли: нашил, 
лапин: пинал, 
уродовали: орудовали, 
проводила: продавило, 
лишаю: илюша, 
завалинок: возникала, 
замочил: замолчи, 
кобаргу: бугорка, 
руднев: дернув, 
дворне: вредно, 
стрижку: стружки, 
шкурки: шкирку, 
неводы: водные, ендовы, 
ушел: улеш, 
челу: лечу, луче, учел, 
ветинара: варианте, 
окурков: коровку, 
теля: летя, тлея, 
ведомого: медового, 
телу: лету, туле, 
прозевал: взопрела, 
лесу: елсу, селу, 
зевласто: засветло, 
спел: слеп, 
плеч: пчел, 
киска: каски, 
макки: каким, 
нашими: шинами, 
осле: осел, село, слое, 
лоре: орел, 
тело: лето, 
лепо: поле, леоп, поел, 
мириам: мирами, 
нель: лень, 
лент: тлен, 
стежкой: жесткой, 
сужают: сжатую, 
страшон: страшно, 
шатки: шакти, кишат, ташки, 
тачки: ткачи, китча, 
катит: катти, 
хикса: исках, 
такси: китса, 
кирча: крича, 
шарик: карши, 
карих: икрах, 
риска: искра, криса, 
шпика: пикша, шапки, 
щипали: лапищи, 
пламене: племена, 
немалое: онемела, 
науки: каину, 
карни: киран, 
нитка: танки, ткани, 
санки: канис, 
икона: инако, инока, 
яками: маяки, 
таким: матки, 
самки: маски, 
рамки: марки, мирка, 
камни: камин, 
стюарда: страдаю, 
лиска: кисла, искал, ласки, 
никла: ланки, клина, 
капли: палки, лапки, 
кашки: кишка, 
шашки: шишка, 
дверных: вредных, 
поднял: полдня, 
заполни: познали, 
сознали: заносил, 
мнозем: земном, 
нанося: сонная, 
чуем: чему, чуме, мечу, 
шуме: мешу, 
тьме: темь, 
темя: метя, 
тему: мету, 
мсье: есмь, семь, 
есмы: мысе, 
семя: смея, емся, 
смех: схем, 
меру: умер, умре, 
трем: метр, 
моет: томе, 
море: роем, 
немо: моне, 
умен: нему, мену, 
головку: уголков, 
оправив: пивовар, 
самый: сымай, 
смайт: таймс, 
вправо: правов, 
майор: марой, рамой, мойра, 
майну: найму, 
наливалось: навалилось, 
окажут: откажу, 
преодолели: определило, 
лежали: жалели, желали, 
ломиться: молиться, 
ценю: юнец, 
горбатя: работяг, 
бродить: дробить, 
сыне: сены, 
неся: ясен, 
сену: унес, несу, 
стен: сент, 
руне: урне, 
пенс: песн, 
рено: норе, 
есно: носе, сено, соне, 
ноет: енот, ноте, тоне, 
полное: полено, 
долго: голод, 
сдирает: сердита, 
мерритом: мортимер, 
лапой: пойла, 
вырвались: врывались, 
майлс: смайл, 
малой: ломай, 
добивалась: добавилась, 
створками: авторским, 
изменена: знамение, 
чеканит: качните, 
техника: хатенки, 
тетинка: канетти, 
плестоу: слепоту, опустел, 
сознавали: засновали, 
впечатление: пантелеевич, 
голландец: голландце, 
обрывает: вобратые, 
кертина: картине, кретина, 
пенителя: плетения, 
отец: отце, 
росе: серо, 
орет: роет, трое, роте, 
орех: хоре, 
форе: офер, 
перо: поре, 
поет: поте, 
придает: пердита, 
карой: аркой, йорка, 
удержит: дежурит, 
годку: гудок, 
майку: кайму, 
харта: рахат, 
татар: трата, 
словес: воссел, 
кайло: ойкал, 
уловили: уволили, 
отнеслись: теснилось, 
тарас: стара, 
койка: какой, 
осовел: волосе, 
повело: полоев, 
укажет: кутежа, 
такоже: окажет, 
шайку: кушай, 
жестка: скажет, стежка, 
медицина: единицам, 
устьем: суметь, 
имогены: гонимые, 
коллега: келлога, 
свободен: небосвод, 
мещанки: щенками, 
завалился: заливался, 
манерки: каминер, 
груди: гидру, 
голоде: долгое, 
призвано: пронизав, 
словам: сломав, свалом, 
пьет: петь, 
прет: треп, петр, 
перу: репу, 
докончила: лодочника, 
птаха: пахта, 
приду: пруди, 
ревнул: вернул, 
праша: параш, 
парах: праха, храпа, 
придя: пряди, 
сдохли: сходил, 
термине: трением, 
семенит: снимете, 
внимание: вениамин, 
перикла: реплика, 
смесью: смеюсь, 
хапая: пахая, 
желают: жалеют, 
тяжела: желтая, 
желать: жалеть, лежать, 
подешевел: подешевле, 
целестин: лестнице, 
сотворил: своротил, 
ящер: щеря, 
трусил: струил, 
дэнис: сэнди, 
трясли: стряли, 
представляло: предоставлял, 
тэнди: дэнти, 
гордое: городе, дороге, 
сновал: славно, 
планов: плавно, 
стер: сетр, 
сеть: сьте, есть, 
сует: утес, 
бруно: бурно, 
поругать: погутарь, 
исход: сходи, 
динго: гидон, 
кутать: тукать, 
рокового: оговорок, 
рыбаков: обрывка, 
пропустила: проступила, проступали, 
справили: исправил, 
шукать: кушать, 
принятые: приятные, 
изобличали: изобличила, 
учтем: мечту, 
избила: забили, 
пропустим: приступом, 
проступили: пропустили, припустило, 
ствола: встало, 
вросла: соврал, сорвал, 
избрал: разбил, 
обнажены: набожные, 
провал: порвал, 
плотва: платов, 
задними: мадзини, 
валуны: вынула, 
учет: чует, чету, туче, 
родни: родин, 
шутите: утешит, 
представило: предоставил, 
пожалеют: пожелают, 
пожелать: пожалеть, полежать, 
заерзал: зарезал, 
стана: санта, наста, 
нарах: ранах, 
кочегар: кочерга, 
устрою: острую, 
запрудила: запудрила, 
шепнул: шлепну, 
получат: отплачу, 
плетню: плюнет, 
плетня: ляпнет, 
облаков: бокалов, 
паутинка: капитану, 
месть: сметь, 
гостиную: огнистую, 
органом: огромна, 
смеху: схему, 
отсекут: тоскует, 
ничком: кончим, 
томкин: тонким, 
смету: месту, 
друге: груде, 
наступил: пластину, напустил, 
углового: лугового, 
стоившей: отвисшей, 
казачек: казачке, 
эрама: маэра, 
храма: рамах, 
марша: шрама, 
тарам: марта, 
муара: амура, 
картечи: чиркает, 
почуяла: получая, 
задрались: раздались, 
старике: кертиса, 
царские: цесарки, 
старикан: старинка, 
бремена: наберем, 
поглотив: пивоглот, 
зардевшись: раздевшись, 
такая: катая, 
диком: домик, 
лодки: долки, 
мутер: умрет, 
нагоном: намного, 
мостик: мостки, 
давались: давилась, 
риском: римско, 
угадан: наугад, 
трепета: патрете, трепает, 
подавали: подавила, повидала, 
радовали: даровали, 
трюме: тюрем, 
наводила: данилова, 
повредил: приделов, 
талла: латал, 
денег: негде, 
исходил: сходили, 
слывет: светлы, 
талая: таяла, 
халат: талах, латах, 
ссала: ласса, 
стала: салат, атлас, талас, 
ялапа: лапая, 
палач: плача, 
пахал: пахла, лапах, хапал, 
лапша: палаш, 
плата: палат, патла, 
пласа: палас, спала, 
спертый: пестрый, 
прощай: пращой, 
плана: напал, 
хлама: ламах, махал, 
загнали: изгнала, 
глазами: замигал, 
соверен: северно, 
достала: солдата, 
лошадник: нашкодил, 
прижила: прижали, 
образовались: базировалось, 
яйулилла: аллилуйя, 
выкрасил: скрывали, 
окончен: конечно, кончено, 
писанию: испанию, 
конюшне: конюшен, 
тупо: утоп, поту, 
сопя: пояс, 
стоп: пост, 
пору: упор, 
поуп: попу, 
обратают: работают, 
работать: обратать, 
писания: испания, 
заключали: заключила, 
сакса: касса, 
карша: кашар, 
акрах: краха, 
лампас: псалма, 
выпустив: выступив, 
канта: канат, 
крана: аркан, ранка, 
маяка: макая, 
матка: актам, 
карам: марка, макар, мрака, карма, 
маска: самка, 
скала: ласка, 
качал: калач, 
капал: лапка, палка, 
крала: карла, 
накал: канал, клана, 
корову: уроков, 
восток: скотов, стоков, 
полтавской: платовской, 
сараи: раиса, 
димси: сидим, 
место: тесом, мосте, смоет, 
пробега: погреба, 
чемто: отчем, 
проем: пером, помер, 
метро: троем, 
трою: торю, роют, 
желаешь: жалеешь, 
форт: торф, 
роту: утро, орут, 
росы: сыро, 
рост: сорт, торс, стор, трос, остр, 
чулана: началу, 
вызвал: взвыла, взывал, 
кажется: жесткая, 
талант: атлант, 
майна: айнам, 
малай: лайма, 
актерами: материка, 
пайла: лапай, 
вызова: вывоза, 
соплюха: полюсах, 
листовка: вокалист, 
прилавок: приковал, 
дурною: родную, 
словарик: рисковал, 
вопроса: просова, 
темно: монет, тонем, монте, 
номер: мерно, морен, 
бордо: бород, бодро, добро, 
сухо: соху, 
иванкова: ивановка, 
соты: сыто, 
броду: добру, 
бродя: бодря, дробя, обряд, 
роптала: портала, 
броды: добры, бодры, 
лопата: оплата, отпала, 
сосу: соус, 
пастыри: пиастры, 
фуражке: фуражек, 
черной: речной, 
ланаи: лиана, алина, 
продавать: оправдать, 
алиас: алиса, 
тесной: стеной, сотней, 
атаки: итака, 
икара: ирака, 
подыграет: подрыгает, 
вонзить: звонить, 
неверно: нервное, 
лавочник: лавчонки, 
сажал: сжала, 
острова: ростова, 
строку: костру, 
костры: скрыто, 
ядерное: ядреное, 
немом: мнемо, 
низовцы: возницы, 
питером: терпимо, 
внесены: вынесен, 
кусанул: куснула, 
итальянце: итальянец, 
вставила: вставали, 
спасал: спасла, 
лапать: пальта, 
палату: путала, 
алмаз: мазал, 
знака: наказ, 
мизинец: мизинце, 
курсов: сурков, 
теклина: летника, клиента, 
заорут: разуто, 
алешкин: шинелка, 
карлине: нарекли, 
щелками: клещами, 
зарыто: заторы, 
народами: адрианом, 
расступившимися: распустившимися, 
протее: потере, 
быдло: болды, добыл, 
кормака: каморка, 
придите: приидет, 
локарно: окорнал, 
лоханку: уклонах, 
бросать: собрать, 
явились: сильвия, 
избушек: избушке, 
арктике: крикета, краткие, 
садам: адамс, 
дамах: ахмад, 
дамам: мадам, 
тополь: полоть, 
падай: айпад, 
горбун: бургон, 
служка: служак, 
загнула: газанул, 
хадза: задах, 
явлении: влияние, 
вступали: вступила, впустила, 
вступят: впустят, 
придела: предали, 
горбатая: работяга, 
удара: уарда, 
положим: пожилом, 
воспитали: поставили, 
прослойку: скорлупой, 
включали: включила, 
отправили: потравили, 
салаг: гасла, 
частот: тотчас, 
запотевшие: затопившее, 
кладите: диалект, 
сиделка: сладкие, 
дроботно: добротно, 
ганна: наган, 
ранга: ангар, 
следами: седлами, 
следила: исделал, сделали, седлали, 
острову: ростову, 
жилками: жалкими, 
испиваше: писавшие, 
напрямик: напрямки, 
пунктами: путникам, 
кажном: ножкам, 
наследников: винландское, 
канав: каван, вакан, 
звала: завал, 
прозаиков: паровозик, 
нажав: важна, 
глава: влага, 
садовник: сводника, 
ободрит: одобрит, 
оврагом: громова, 
врата: трава, 
будки: дубки, 
вопит: типов, 
долби: добил, добли, 
хорив: хвори, вихор, 
аванс: саван, 
нрава: нарва, навар, 
аврам: мавра, 
будни: дубин, 
жареного: горожане, 
впала: павла, 
лавра: арвал, рвала, 
творили: вторили, 
усвоили: условии, 
ужинали: унижали, 
винигер: венгрии, 
полой: пойло, 
загонах: газонах, 
накормит: романтик, 
политрук: покрутил, 
натиском: томкинса, 
кварта: травка, 
бурке: рубке, берку, 
звонко: звонок, 
такова: октава, 
банде: бедна, 
берда: бедра, 
камеронец: конармеец, 
барду: бурда, 
блоке: облек, белок, 
выведен: введены, 
брода: добра, 
обрек: кобре, 
бочек: бочке, 
дамбу: дубам, 
противна: напротив, 
саланки: салкина, 
отрезая: озаряет, 
скалами: ласками, 
латками: климата, 
лапками: палками, 
верностью: ревностью, 
нитки: тинки, 
пинки: пикни, 
улики: уикли, уилки, 
лиски: силки, 
сладком: складом, 
поминают: понимают, 
поминать: понимать, 
крики: кирик, 
укатила: укатали, 
чирик: кричи, 
каваны: канавы, 
тиски: кисти, 
пикши: шпики, 
капитал: палатки, 
валках: лавках, 
сладко: сладок, 
звяком: вязком, 
бегал: благе, 
берга: герба, брега, 
завалились: заливались, 
коленце: коленец, 
окриков: коровки, 
бугра: груба, 
править: впарить, 
богра: гроба, багор, 
губам: бумаг, 
белой: бойле, болей, 
обходи: обиход, 
бодрит: бродит, 
дорогах: городах, 
котлом: лотком, толком, 
полком: клопом, 
невыгоды: выгодные, 
протекли: пролетки, 
фронтами: митрофан, 
хитроумны: хуторными, 
наврал: нарвал, 
доскам: адском, 
сложенными: несложными, 
заборах: образах, 
бытие: битые, 
тибет: бетти, 
кадмон: команд, 
сингиных: исгинных, 
браво: баров, рабов, 
возразили: развозили, 
погудко: погодку, 
засновал: сознавал, 
римского: мирского, 
обвал: балов, 
стручке: трескуч, 
берли: брели, 
укротило: укоротил, колориту, 
капитан: напитка, антипка, 
арапник: капарин, 
поступали: поступила, 
бурав: убрав, 
бросалась: собралась, 
лежавший: желавший, 
травма: вратам, 
пансионом: описанном, 
войны: новый, 
изменила: заменили, 
впустили: вступили, 
зарядов: разводя, 
зебры: брезы, 
уволить: уловить, 
знавшему: узнавшем, 
шкуры: крышу, 
выпустить: выступить, 
мчатся: частям, 
манатки: танками, 
разжевали: заржавели, 
машинка: макниша, манишка, 
рамками: марками, 
масками: максима, 
остраненной: настроенной, 
ручку: чурку, 
врезалось: развелось, 
доусон: доносу, 
ведавший: видавшей, 
теснее: несете, 
гомеровы: громовые, 
покуда: упадок, 
послан: сполна, 
полная: поляна, поняла, 
застрявшие: завершится, 
наделали: наделила, 
штату: тушат, 
отпустит: отступит, 
грызной: грозный, 
отвара: автора, товара, 
предлога: подергал, 
стычек: стычке, 
сигналов: салингов, 
ремонтов: терновом, 
белел: белле, 
более: белое, 
проживу: привожу, 
дубить: будить, 
царствие: австриец, свитцера, 
кругом: громку, 
громко: громок, 
тонула: тулона, 
салону: ноулса, 
крысу: сырку, курсы, 
потянись: пояснить, 
разделась: зарделась, 
чиновный: овчинный, 
стойкими: мистикой, 
дураку: украду, 
переулочке: переулочек, 
проливы: провыли, 
хапнул: пахнул, 
ладошку: лошадку, 
удавив: увидав, 
отменный: монетный, 
лошадок: шоколад, 
темнее: немеет, 
струятся: трясутся, 
теремов: мертвое, 
обманул: буланом, 
выпустили: выступили, 
ногтястый: тягостный, 
должно: должон, 
сунула: уснула, 
отворил: воротил, 
повисло: сопливо, 
борделя: броделя, 
бигмена: бингема, 
ездили: дизели, 
старика: актриса, 
беаринг: бергина, 
нарушались: нарушилась, 
полнился: исполнял, 
островах: хвороста, 
воевал: овевал, 
отдыху: духоты, 
римская: мирская, 
летучие: учителе, 
ногою: юного, 
огульно: угольно, 
головенки: велогонки, 
ростков: костров, 
уолтерса: устарело, 
славное: свалено, 
ручками: кручами, 
мурашки: шкурами, 
таковы: октавы, 
свалены: вынесла, славные, 
недолго: голоден, донегол, 
котелком: клекотом, 
высказались: сказывались, 
ногтю: гонют, 
ногтя: гонят, 
отвесить: осветить, 
каменело: окаменел, 
жилу: ужли, лужи, 
ожил: ложи, жило, 
анархист: христана, 
коутсов: востоку, 
гавани: вагина, 
провела: провале, 
воздали: заводил, 
поверят: потеряв, 
флетова: лафетов, 
посверх: превосх, 
подогревай: гепардовой, 
поселок: полоске, плоское, 
потекло: потолке, 
бабочек: бабочке, 
тужи: жути, житу, 
монеткой: кометной, 
повалили: поливали, 
отвалили: отливали, 
колотье: околеть, 
штуками: мишатку, шутками, матушки, 
невада: девана, 
давина: дивана, 
видала: давали, давила, 
мальчишек: мальчишке, 
посту: пусто, 
исполни: ипсилон, 
посты: стопы, 
решета: решает, 
травку: кварту, 
освещались: совещались, 
сложные: сложены, 
изволили: изловили, 
продали: придало, подарил, 
настрой: страной, 
распылить: присылать, 
уродила: ударило, 
глядело: оглядел, 
бессчетные: бесчестные, 
сядут: судят, 
завела: зевала, 
измененными: неизменными, 
кожу: ужок, 
канаве: каване, 
прерогативы: проигрывает, 
спорт: прост, 
спору: сопру, 
прося: споря, 
порту: тропу, 
тропы: порты, 
навеса: саване, 
взлягнув: взглянув, 
вызвать: взывать, 
происходят: проходится, 
адресован: андерсова, 
насылает: атласные, 
долинах: находил, 
станислав: насвистал, 
граничат: трагична, 
лошадках: ладошках, 
торпеду: трупоед, 
выскочкам: скачковым, 
порвала: провала, 
забирал: избрала, разбила, забрали, базарил, 
базками: камбиза, 
ножик: ножки, 
жилок: ложки, 
желавших: лежавших, 
бродил: бодрил, 
дублин: блудни, 
екатеринодар: катеринодаре, 
гряду: грудя, 
груду: другу, 
неправоту: повернута, 
знавал: назвал, 
завалы: завыла, 
границы: граныци, 
стилку: скулит, 
капризом: приказом, 
заявилась: заливаясь, 
горения: героиня, 
ужом: можу, 
оторви: вороти, отвори, 
фрицы: цифры, 
тостер: сотрет, стерто, 
нетопыря: опрятные, потеряны, 
партнеров: превратно, 
свертывая: врывается, 
сложено: сложное, 
толкует: котлету, 
отлучке: телочку, отлучек, 
закопать: показать, 
онемели: моление, 
выпустит: выступит, 
впустить: вступить, 
арапника: капарина, 
стрямок: стрямко, 
епископов: поповские, 
ольстер: терлось, 
валика: кивала, 
лавами: валами, 
извечного: возничего, 
авария: аравия, 
оснастке: секстона, 
ограбили: болгарии, 
мирошка: ромашки, 
гранада: награда, 
махорки: крохами, 
платьев: плевать, 
неотложных: отложенных, 
тимошка: отмашки, 
просвета: постарев, 
облепили: побелили, 
костоправ: простаков, 
расой: ройса, 
сказываться: высказаться, 
повидаться: подавиться, 
воротам: отваром, товаром, автором, 
город: дорог, гордо, 
удалить: уладить, 
паровом: поваром, 
аварии: аравии, 
придавали: придавила, 
пустяки: искупят, 
творит: вторит, 
аппарате: парапета, 
красноте: коренаст, 
кнутами: минутка, 
манишку: машинку, 
тканями: маятник, 
нотками: макинто, 
кронами: накорми, 
монашки: машинок, 
пехота: потеха, пахоте, 
ирландия: нарядили, 
несущими: смущении, 
хватало: отвалах, 
догоню: годною, 
район: раной, 
лопатники: политикан, 
трапезою: запертою, 
забегали: избегала, 
городом: дорогом, 
загребла: загребал, 
обнажались: обнажилась, 
заправилы: призывала, 
брешет: шербет, 
глушине: шелингу, 
стерло: солтер, 
одинаковом: коноводами, 
рыхлое: холеры, 
красоту: рукасто, 
увидит: удивит, 
перевес: пересев, 
выступали: выступила, выпустила, 
саттон: статно, 
головореза: лазоревого, 
сядьте: десять, деться, 
слезал: слезла, 
проезда: подреза, 
дивной: двойни, 
август: густав, 
дивный: видный, 
шапку: пушка, 
пытка: пакты, 
соловья: волосья, 
пупка: папку, 
засеял: слезая, 
таланта: атланта, 
настала: салтана, 
постаралось: опросталась, 
вызвала: взывала, 
опьянил: пьянило, 
ненаедный: найденные, 
честными: нечистым, 
симметрия: симмертия, 
оторопев: повороте, портовое, 
холсте: схотел, 
гнездышек: гнездышке, 
отселя: отсеял, 
отсель: летось, 
клекот: клеток, 
ужимками: мужиками, 
ругать: гутарь, 
местов: вместо, светом, 
сальная: альянса, 
ветром: метров, втроем, мертво, 
шатко: шаток, 
кофта: факто, 
токах: котах, 
порвем: первом, 
замену: узнаем, 
зароем: озерам, 
стока: тоска, аскот, скота, 
урока: укора, 
оскар: срока, 
капот: покат, 
попка: папок, 
порка: парок, 
покормила: промокали, 
полосками: исполкома, 
венский: невский, 
разуме: маузер, 
кроатов: товарок, 
предостерегал: предостерегла, 
тронули: отринул, 
старикам: актрисам, 
слаженно: несложна, 
вылизав: вызвали, взывали, 
гонец: гонце, 
кнута: нутка, 
резона: разное, озарен, 
краны: рынка, 
ранку: крану, 
нравом: равном, 
каноэ: коэна, 
нотка: тонка, 
корна: норка, крона, анкор, 
удвоил: уводил, 
сводил: сдвоил, 
канун: канну, 
внесете: невесте, 
ломились: молились, 
чутьем: мучьте, 
приемник: прикинем, 
трепло: пролет, 
пухлое: оплеух, 
озабоченно: обозначено, 
обнажил: жлобина, 
струков: створку, 
марку: рукам, курам, рамку, мраку, 
огнем: геном, 
заорет: заторе, 
мочка: очкам, 
актом: маток, таком, мотка, 
раком: марко, комар, марок, корма, 
самок: косам, масок, 
кампо: компа, 
гумен: гумне, 
окнам: манко, 
дисков: сводки, 
подвалил: подливал, 
громе: горем, гомер, морге, 
мамку: мукам, 
семгу: гусем, 
подчеркивает: передатчиков, 
ускорьте: отрекусь, 
справок: впросак, 
макуш: мушка, 
матку: тумак, уткам, 
сумка: маску, максу, самку, 
мылся: мысля, 
армяк: краям, 
крепок: крепко, 
крошке: крошек, 
лобика: облика, 
окошек: окошке, 
мучения: учиняем, 
банкир: баркин, 
кубани: кабину, 
холка: кохал, 
солка: ласко, оскал, 
толка: котла, катол, лотка, 
полка: лапок, палок, 
миндаль: дальним, 
щекочут: щеточку, 
кулан: канул, 
диплома: плодами, поладим, 
дивных: видных, 
ломка: лаком, ломак, 
дивную: видную, 
разрушила: разрушали, 
октавой: таковой, 
грело: огрел, горел, горле, 
долинам: лимонад, 
трапез: запрет, заперт, 
точеные: отечные, 
залучить: излучать, 
обыграть: богатырь, 
суетного: согнутое, 
кушал: шкалу, клуша, 
тыкла: тыкал, 
латук: кутал, 
ласку: скалу, кусал, 
клары: крыла, карлы, 
карлу: украл, 
лапку: палку, купал, 
отпустили: отступили, 
горсти: сгорит, строги, 
читателем: мечтатели, 
ободряя: одобряя, 
ревенем: времене, 
бранил: раблин, 
конторе: тенорок, 
рубила: убирал, убрали, 
обитал: отбила, 
делана: надела, андела, 
послания: пояснила, 
комка: каком, оккам, 
труба: брату, 
кулак: лукка, кукла, 
локка: клоак, 
торбу: борту, турбо, 
сруба: бруса, 
легок: легко, 
писцами: спицами, 
родинки: родники, 
поладил: подлила, 
горек: греко, 
видным: дивным, 
кучка: качку, 
кушак: кашку, 
куска: каску, скука, скаку, 
отборе: роботе, 
кошак: кошка, 
качко: кочка, 
рубах: барух, 
ослом: мосол, 
отмол: молот, 
пылом: помыл, 
полям: помял, 
мослы: смыло, смолы, 
полом: помол, 
гиену: генуи, 
рушник: шнурки, 
гриме: греми, 
гения: гинея, 
труп: прут, тпру, 
дерзать: раздеть, 
уиллса: услали, сулила, 
осатанел: атласное, 
лошила: лишало, 
опалил: палило, 
лучом: молчу, 
машинках: манишках, 
черными: речными, 
смотринам: монстрами, 
издала: задали, 
окраинам: иномарка, 
назади: издана, 
варейкис: красивей, 
схоронила: сохранило, 
барыни: рабыни, 
черткове: четверок, 
пристойное: построений, 
рубани: барину, 
набито: тобина, 
задрал: разлад, 
задавило: заводила, 
батину: баунти, 
просторам: просмотра, 
стонете: тесноте, 
ослами: сомали, 
мотали: томила, 
ступ: пуст, 
лимона: манило, нимало, 
минула: малину, 
маслин: снимал, 
робот: отбор, 
гиней: гений, 
отбою: тобою, 
гинеи: гении, 
задавить: издавать, 
книге: кинге, 
мучила: умчали, лучами, 
согрели: сгорели, 
переставали: переставила, 
броха: робах, 
утробе: обрету, отберу, 
торба: работ, борта, 
потеки: топкие, 
иголкой: логикой, 
чероки: очерки, 
плетеном: потемнел, 
келлог: коллег, 
истоке: отсеки, 
потравленный: отправленный, 
либене: белени, 
сучонке: чесноку, скучное, 
томпсон: постном, 
ибсене: небеси, 
знаться: заснять, 
путы: тупы, 
чествовали: отсвечивал, 
порочность: чопорность, 
пробить: побрить, 
уборкой: кобурой, 
весящий: висящей, 
главой: влагой, 
буяна: баяну, 
банту: бунта, табун, 
ледяной: деляной, 
бурна: браун, убран, 
отпрянула: протянула, 
набор: барон, 
пестик: степки, 
отнимет: отменит, 
тупике: купите, 
сенцы: сцены, 
крепит: трепки, крипте, 
персик: спикер, скрипе, 
грете: греет, 
окружные: окружены, 
разному: разумно, 
выпустим: выступим, 
ротному: муторно, 
семеновой: невесомой, 
уснет: сунет, стену, несут, снует, 
стеня: тесня, 
стены: тесны, 
чемпион: нипочем, 
степное: понесет, 
пресное: персоне, перенос, 
истлевшей: слетевший, 
ромбиками: микробами, 
самбо: басом, 
рабом: баром, 
гнездов: невзгод, 
огонек: некого, 
рыбак: крабы, рыбка, 
копием: поимке, 
рубка: бурка, браку, бурак, 
ренту: турне, унтер, нутре, 
осенним: сенином, 
переводит: проведите, 
червонцы: черновцы, 
добирая: обдирая, 
ееего: егоее, 
сдвоило: сводило, 
стекли: листке, 
жанейро: жареной, 
куилте: ликует, 
летчик: кличет, 
плетки: плитке, 
реплик: крепли, перикл, крепил, 
голова: логова, 
купели: упекли, 
посланием: полисмена, 
брезгает: загребет, 
зараженные: зажаренные, 
табло: болта, 
балор: брало, 
слабо: ослаб, 
гнусавит: августин, 
команда: кадмона, 
уступок: отпуску, 
аккорду: кокарду, 
пинкер: перкин, 
заботясь: заботься, 
рескин: серник, 
отпускаю: опускают, 
вырвалась: врывалась, 
отварной: товарной, 
втянуты: вытянут, 
развалив: развивал, 
рестую: струею, 
берут: трубе, 
трясет: трется, 
собак: бокса, басок, 
банок: набок, 
сметки: кисмет, 
клуба: балку, 
гулкое: уголек, уголке, 
балок: бокал, блока, облак, 
выпасть: всыпать, 
желаете: жалеете, 
платочке: платочек, 
кокарды: аккорды, 
протекал: протекла, пролетка, 
стеснит: стиснет, 
тошен: нешто, 
нечто: точен, 
басит: сбита, 
норте: тенор, троне, 
сосен: сосне, 
отнес: стоне, тесно, сотен, сотне, 
сохен: снохе, 
иосиф: софии, 
банши: башни, 
брани: брина, барни, бирна, барин, 
обтер: борет, 
уборе: бурое, 
провезли: произвел, 
рябое: борея, робея, 
свалиться: сливаться, 
снопе: понес, 
забором: образом, 
походил: подохли, 
атласно: настало, стонала, 
вагоны: выгона, 
подвозе: поездов, 
голенькой: легонькой, 
повалены: плановые, 
оставлен: властное, 
ротонда: отрадно, 
зубра: арбуз, 
поноса: опасно, 
забор: образ, 
мебель: бельем, 
наростом: сторонам, астроном, 
политику: откупили, 
азбук: зубка, 
подавило: поводила, 
раздели: дерзали, 
тенистое: теосинте, 
переговорное: переговорено, 
врезалась: развелась, 
подлить: плодить, 
ерзали: релиза, резали, 
брали: ларби, 
сабли: сбила, басил, 
бакли: балки, 
браки: барки, 
замени: измена, 
резина: резани, 
истин: синит, 
участке: скучает, 
кертис: трески, 
передом: проедем, 
синим: сними, 
минин: минни, 
накормив: кирваном, 
биржа: баржи, 
небом: беном, обмен, 
суринаме: нарисуем, 
запустит: заступит, 
материны: минареты, 
издайте: зайдите, 
базой: забой, 
келлогу: коллегу, 
выручали: выручила, 
этими: эмити, 
басен: басне, 
башне: башен, 
блеют: блюет, 
абеля: белая, 
протянули: отпрянули, 
браке: кабре, берка, 
белка: балке, 
белых: хлебы, 
набей: баней, 
белло: болел, 
обмел: белом, 
робел: обрел, 
берта: треба, брате, 
любое: болею, белою, 
привстали: приставил, 
мизерного: незримого, 
лесопилок: поколесил, 
линчи: чинил, 
иффли: лиффи, 
верность: ревность, 
разов: взора, 
навоз: звона, вазон, 
вязал: взяла, 
кошелке: кошелек, 
залив: звали, 
свази: завис, 
пахуче: чепуха, 
воспитав: поставив, 
вороту: оторву, 
отправив: потравив, 
принято: приятно, 
остров: сортов, востро, ростов, сторов, 
гербом: бергом, 
выменяли: вялеными, 
премиями: империям, 
морозу: узором, 
полижи: пожили, 
сломать: малость, 
красовался: расковался, 
достал: солдат, 
утешник: шутнике, 
живал: лжива, 
поседел: последе, 
двуколка: кладовку, 
принятых: приятных, 
казановы: закованы, 
вестись: светись, 
отбирать: обратить, обтирать, 
споров: вопрос, 
повтор: портов, 
напустив: наступив, 
приложу: пожурил, 
обратите: отбирает, 
достало: стодола, 
отступил: отпустил, 
несложно: осложнен, 
подпало: подпола, 
мужики: ужимки, 
невстреча: встречена, 
карев: краев, 
ванек: навек, венка, 
лавке: валке, 
вешай: вашей, 
просаживали: просиживала, 
пожалеет: пожелает, 
северном: всемерно, 
засев: завес, зевса, 
зевак: зевка, 
зевал: везла, завел, 
ставках: схватка, 
верстак: верстка, 
счете: сечет, 
рявкает: ветряка, 
свахе: весах, 
вчера: чрева, 
пробег: погреб, 
ветра: траве, 
равен: нарве, верна, 
весна: навес, 
левша: вешал, 
свела: слева, славе, весла, 
павле: павел, 
давит: твида, 
видам: давим, 
видна: давин, диван, 
видал: давил, вдали, 
деван: надев, 
принята: приятна, 
ведал: девал, левад, 
ведра: вреда, древа, 
искурен: рескину, рисунке, 
кирстен: рискнет, 
девка: давке, 
сырее: серые, 
монголов: головном, 
отвесными: неистовым, 
дремоту: мордует, 
марсель: рельсам, 
водах: входа, 
овода: адово, 
двора: дрова, даров, 
садов: свода, 
оглянул: глянуло, 
ванды: выдан, 
лопаткам: плакатом, 
перелески: пересекли, 
солидно: доносил, 
высказал: сказывал, 
хлопая: плохая, 
горелку: круглое, 
поучал: оплачу, 
старовер: растворе, 
утопла: лопату, путало, оплату, утопал, опутал, 
лопать: пальто, лапоть, 
лопаты: оплаты, 
роптал: портал, 
бенамор: бремона, 
копий: кипой, пикой, 
ободрения: одобрения, 
петер: терпе, петре, 
перец: перце, 
оплетенную: нетопленую, 
тарифов: фаворит, 
листках: слитках, 
катился: таксиля, 
скалить: таксиль, 
сельди: делись, 
старушке: старушек, 
говна: вагон, 
остыла: отсыла, 
холста: столах, 
сальто: алость, 
главу: влагу, 
трескать: скатерть, 
осликов: волоски, 
грива: вираг, враги, 
лысиков: выкосил, 
прождала: подражал, 
волоскам: ласковом, 
единым: медины, 
исполните: потеснили, 
стукачом: участком, 
капустой: отпускай, 
пожелай: пожалей, 
выместил: светлыми, 
чепце: чепец, 
вдова: ввода, 
соков: совок, 
колени: неколи, 
клиент: кетлин, летник, 
тучных: хнычут, 
рывок: ковры, 
квоты: отвык, 
свояк: всяко, 
ковшу: вошку, 
вылазок: вокзалы, 
украсил: русалки, 
комкая: маккоя, 
кромка: кормак, 
покоренный: непокорный, 
ниточке: кончите, 
откинет: оттенки, 
сферой: фросей, 
посерел: пересол, 
слепоте: постеле, 
заставила: заставали, 
мирском: римском, морским, 
свернет: вестерн, 
отсталые: отсылает, 
подбивать: подбавить, 
окунул: клоуну, 
самозванец: самозванце, 
консул: склону, 
грозами: розгами, 
штучек: штучке, 
оплешивел: пошевелил, 
летопись: поселить, 
несет: тесен, стене, 
марано: романа, морана, 
песне: песен, 
обрести: бросите, 
аманту: тумана, 
проживало: провожали, 
злит: тизл, 
невесты: вынесет, 
вступил: впустил, 
пригладив: придвигал, 
прохватило: хрипловато, 
наотрез: отрезан, 
угощением: неимущего, 
бродила: обдирал, 
перстом: пестром, 
делимо: модели, 
трясут: трусят, трутся, 
несем: семен, смене, 
гривка: гаврик, 
стоячим: мочится, 
смехе: схеме, 
месье: семье, 
спросили: испросил, 
испортил: простили, 
челюсти: чистюле, 
смеет: месте, 
узок: узко, козу, 
ездившая: завядшие, 
выбрали: выбирал, 
николса: салоник, 
копнила: накопил, поникла, 
кончали: кончила, 
окунали: окинула, окалину, 
николаю: алкиною, 
выразилась: зарывались, 
смутного: согнутом, 
мастеру: суматре, 
густо: стогу, 
волку: луков, 
ловок: ловко, 
чопорная: порочная, 
перенести: принесете, 
станете: стенает, 
воздание: изведано, 
емлет: мелет, млеет, 
донкина: донника, 
тупости: отпусти, опустит, 
пепел: пепле, 
лепет: петле, тепле, 
лозы: золы, 
лозу: золу, 
милости: илистом, 
увлекал: увлекла, 
моталки: ломтика, котлами, 
валенок: неловка, 
чмокали: милочка, 
лавочке: лавочек, 
колина: наколи, 
канули: калину, икнула, кинула, 
макнил: малкин, 
микола: маколи, 
кружек: кружке, 
плитка: платки, 
вспомнила: вспоминал, 
потчуем: помечут, 
окатил: толика, 
проходах: храпоход, 
дамочки: дочками, 
садиком: досками, 
клеем: мелек, 
жидогрек: грекожид, 
листка: скалит, слитка, тискал, 
хаксли: лисках, 
кричал: чиркал, ларчик, 
скарли: красил, 
украли: курила, 
перевела: перевале, 
укатил: улитка, кутали, 
героине: регионе, горение, 
скупали: пускали, искупал, 
семанги: снегами, 
газона: загона, 
хруста: страху, старух, трусах, 
отбывали: бытовали, 
грозой: розгой, 
городу: дорогу, 
богатеют: отбегают, 
токами: томика, котами, 
аксиом: косами, соками, 
ярками: краями, 
руками: имурка, 
огород: дорого, 
окнами: моника, маниок, 
господин: господни, 
шатким: шматки, 
калипсо: поискал, 
лопатки: покатил, 
кислота: столика, 
несутся: сунется, 
заботы: забыто, 
картинок: наркотик, 
гасила: салаги, 
заборы: образы, 
гамаши: шагами, 
образу: забору, 
освоился: сословия, 
сухаря: ярусах, 
станки: натиск, 
колонке: коленок, 
инеем: емени, 
туника: кинута, 
осанки: носика, 
тоника: аконит, токина, 
крониа: иранок, 
гребне: берген, 
песчинка: песчаник, 
птенчика: печатник, 
гребет: брегет, 
грубее: уберег, берегу, 
сбивало: обвисал, 
шорты: шторы, 
навалились: наливались, 
розу: узор, 
пузо: позу, 
зарницы: разницы, 
капиталу: капитула, 
катеров: актеров, 
сковала: ласкова, 
редкого: городке, 
гордую: другою, 
впуститься: вступиться, 
лезем: земле, 
бодрой: доброй, 
описка: поиска, опаски, 
покати: опатки, 
через: резче, 
бигмен: гибнем, 
бодрый: добрый, 
чушка: чашку, 
колышке: колышек, 
княжне: княжен, 
разливались: развалились, 
гукала: агукал, кулага, 
приколота: притолока, 
стряпки: скрипят, 
сорту: росту, сотру, 
острю: строю, 
торсы: тросы, 
стерпели: пестрели, прелести, 
ступив: впусти, пустив, 
ссору: руссо, 
ссоры: россы, 
кутая: тукая, 
тачку: тучка, 
ташку: шутка, штука, тушка, 
кассир: раскис, 
кирста: старик, красит, старки, актрис, 
самолет: сломает, 
чековая: кочевая, 
крипта: киртап, патрик, 
сбивать: сбавить, 
кровеносных: сокровенных, 
долохов: холодов, 
жестко: жесток, 
сделанный: наследный, 
аналог: логана, налога, 
угасал: угасла, 
скату: скаут, стука, куста, таксу, 
скатился: скитался, скалится, 
кассы: саксы, 
парочку: прокачу, 
искать: катись, 
ермаков: ревкома, 
стачки: чистка, 
означает: заточена, 
локлина: клонила, 
катались: катилась, 
оскалил: коллиса, 
спятила: питался, 
ступали: ступила, спутали, пустила, 
поминали: понимали, 
томилина: отнимали, 
слежку: скулеж, 
принимал: приминал, 
стерпит: пестрит, 
старинное: настроние, 
сучка: скачу, 
таксы: касты, скаты, 
вибрато: обратив, 
повалилась: оплавилась, 
ладном: надлом, 
рурка: карру, 
приведется: предвестия, 
приучал: причалу, 
сопатку: отпуска, 
палитру: патрули, 
несчетно: нечестно, 
щупает: пущает, 
сочтет: отсчет, 
крыша: шкары, 
капризный: приказный, 
чурка: ручка, 
шкура: круша, 
карты: крыта, 
турка: карту, 
рысак: крыса, 
красу: курса, 
диктора: дротика, 
греты: гетры, 
летнике: теклине, 
травинок: вторника, 
повторила: отправило, 
пребывании: прибывание, 
колену: екнуло, 
радости: дорасти, 
упустила: уступила, уступали, 
приставал: привстала, 
талых: тылах, 
разливавшегося: развалившегося, 
гладишь: галдишь, 
веником: кевином, 
блудницы: дублинцы, 
боярышкина: боярышника, 
работали: отбирала, обратила, 
улочек: елочку, улочке, 
педераст: передаст, 
микроб: робким, 
пантелеем: пламенеет, 
стекол: стекло, 
колесо: колосе, оселок, 
плошке: шлепок, 
поливалка: оплакивал, 
пирате: питера, 
сахул: слуха, 
устал: стула, 
гвинее: гениев, 
стряпаться: спрятаться, 
передашь: предаешь, 
пригнулся: присягнул, 
майерса: майрасе, 
спелых: слепых, 
склоняли: клонился, 
обманов: обновам, 
занести: синтеза, 
рваную: равную, 
приведу: упредив, 
равных: рваных, 
январь: вранья, 
проспать: пропасть, 
подеремся: проедемся, 
одолжили: доложили, 
влачится: вчитался, 
января: равняя, 
хвалится: хватился, 
теплых: пыхтел, 
знанием: знамени, 
локтем: телком, 
броски: скорби, сборки, кросби, 
прокладки: прикладок, 
желала: лежала, жалела, 
комлем: мелком, млеком, 
щупал: пущал, 
лапшу: шпалу, 
пухла: плаху, халуп, 
палят: платя, 
пытал: платы, 
плату: плута, тупал, путал, 
оправляться: отправляясь, 
считать: частить, 
славится: ставился, свалится, 
маманьке: маменька, 
исчезла: исчезал, 
представлено: предоставлен, 
выкипел: выпекли, 
провезти: призовет, 
монашек: монашке, 
чеканом: кончаем, 
комнате: монетка, 
манерок: камерон, анкером, 
нектаром: камертон, 
обильна: альбион, 
вызов: вывоз, 
пилкой: липкой, 
слабину: саблину, 
красителей: рискателей, 
парадокс: распадок, 
ерзала: резала, 
запела: запале, 
стало: стола, 
побрились: пробились, 
лассо: сосал, 
домишек: домишке, 
набилось: альбинос, 
полая: оплая, 
опалю: лапою, 
манжулов: влажному, 
полах: пахло, плоха, 
опалу: упало, 
топал: отпал, плато, толпа, 
салоп: спало, 
самыми: мысами, 
учителям: мучителя, 
пропащую: прощупаю, 
олуха: хоула, 
привязана: признавая, 
облиста: области, 
расчистке: старчески, 
тушит: шутит, 
пробивались: прибавилось, 
сыру: русы, 
обратил: отбирал, 
собрали: бросила, бросали, собирал, 
плану: пнула, 
салон: слона, 
обмолвку: колумбов, 
родинке: роднике, 
курчавого: горчакову, 
приступи: припусти, 
цунами: умница, 
симона: анисом, носами, 
санями: сминая, снимая, 
антрим: мартин, 
подперла: преподал, 
сунул: уснул, 
потерях: похерят, 
податель: поделать, 
забылись: зыбилась, 
ниткой: тонкий, 
ободряюще: одобряюще, 
вовсе: весов, 
ослабли: ослабил, 
плетку: куплет, 
почетную: почунеют, 
лидеров: доверил, 
небосвода: несвобода, 
петрова: правоте, 
тарасов: саратов, 
черствая: встречая, 
упустил: уступил, 
постигали: госпитали, 
талым: тылам, 
масля: смяла, 
сымал: смыла, 
низина: знании, 
ротами: тимора, 
масло: салом, смола, мосла, 
неспортивной: провинностей, 
пятился: пялится, 
забурлит: затрубил, 
налобникам: каннибалом, 
ермака: караем, камера, 
аптека: пакета, капает, 
карета: актера, ракета, 
ящур: щуря, 
вывод: вдовы, 
евдоким: медиков, 
глянула: лягнула, 
влеве: велев, 
розовом: морозов, 
чертова: чревато, 
веков: вовек, 
скрывать: выкрасть, 
левого: логове, голове, 
пылал: плыла, 
яства: ставя, 
свату: устав, 
ормонда: народом, 
слетит: слетти, стилет, 
селить: телись, 
феврале: феврела, 
навалилась: наливалась, 
толкнув: воткнул, 
муштровал: штурмовал, 
отучившись: очутившись, 
волокно: локонов, волокон, 
контур: контру, 
коршун: шнурок, 
терялся: стреляя, 
сестер: сестре, 
тальку: культа, 
мечтами: митчема, 
вдове: вдвое, 
наглости: настигло, 
местные: сметены, 
сменяет: семенят, 
канатом: комната, 
вводи: видов, 
врать: тварь, рвать, 
свары: срыва, 
полон: полно, 
терпения: приятнее, 
наступила: наступали, 
разевал: развела, лазарев, 
погребу: пробегу, 
ходко: ходок, 
бравого: багрово, 
третье: тереть, 
потоки: копоти, 
шкоду: душок, 
чудок: дочку, 
овсянки: синяков, 
откинув: виконту, 
дарлинга: наградил, 
понял: полян, полня, 
прошьет: потрешь, 
тонул: тулон, 
хулно: охнул, 
плести: слепит, 
сумрака: маркуса, 
коровин: воронки, конвоир, 
окончив: новичок, 
седокам: дамское, 
приток: портки, портик, тропки, 
готовясь: готовься, 
прибегало: пробегали, гипербола, 
привил: прилив, 
заметила: заметали, 
ворча: овчар, 
тавро: рвота, товар, автор, отвар, 
авторских: страховки, 
повар: паров, право, 
выдоха: выхода, 
кувшинах: канувших, 
петлями: плетями, 
строки: кристо, ростки, тросик, стирок, 
забивались: избавилась, 
комод: кодом, доком, 
владениях: давлениях, 
корить: кроить, 
кортит: ктитор, кротти, 
мошкара: кошмара, 
божиться: обжиться, 
смыты: сытым, 
ставочку: участков, 
нарыв: нарвы, равны, нравы, 
нраву: нарву, 
марией: армией, 
квинси: свинки, 
новая: янова, 
лозунги: изогнул, 
клавере: клевера, 
потерлась: трепалось, 
валух: хвалу, 
считаем: счетами, 
верстки: свертки, 
вальс: славь, 
тесаки: кисета, 
шаткие: шикает, 
китаец: ацтеки, 
мотыгу: могуты, 
матушка: машутка, 
посевной: пенсовой, 
колод: лодок, 
клоду: лодку, 
ведаться: деваться, 
основе: освоен, 
ровное: вороне, 
мелькание: маленькие, 
выдавили: видывали, 
вялая: валяя, 
америк: реками, ерикам, 
секани: насеки, 
парике: пекари, 
кипела: капели, 
кишела: алешки, 
ссоре: россе, 
квасы: саквы, 
росте: осетр, строе, 
вкуса: сквау, сакву, 
курва: рукав, 
потрясай: распятой, 
якова: вояка, 
шавок: ковша, вошка, 
орешь: роешь, 
васко: воска, 
ковра: акров, 
актов: таков, вокат, квота, октав, 
изрекал: изрекла, 
десятка: детская, 
листовок: сколотив, тоскливо, столиков, ловкости, 
сильном: мнилось, 
разводил: раздвоил, 
личному: уличном, 
внучонка: ванночку, 
свола: слова, совал, 
валом: молва, 
примета: терпима, 
ретила: литера, 
трогаем: моргает, грамоте, 
йорком: кормой, мокрой, 
решали: решила, 
телами: метали, 
месила: лесами, 
немила: милане, 
сбатовали: обставила, бастовали, 
стопе: поест, 
почет: почте, 
отбанила: баталион, 
хопре: хопер, 
отпер: петро, тропе, потер, порет, 
пятое: потея, 
понижать: пожинать, 
показной: запонкой, 
сходни: сдохни, 
орудуют: уродуют, 
неудержно: недружное, 
мечников: венчиком, 
романиста: наростами, 
валку: лавку, лукав, 
ковал: валко, волка, лавок, 
неравен: неверна, 
матине: нетаим, 
ценами: ценима, 
пестовал: вспотела, 
харви: архив, 
твари: трави, варит, 
обнимала: обминала, 
мудреного: немудрого, 
ивану: увина, 
вшами: вашим, 
вахли: хвали, 
врали: варил, рвали, 
виола: олива, 
валит: витал, 
слива: висла, 
вилла: валил, влила, 
вилка: кивал, валик, валки, лавки, 
густом: смогут, 
кулачок: колчаку, 
воровка: кроваво, 
шеврон: шверно, 
виста: свита, 
расторопь: распороть, 
конфетка: кофтенка, 
отрезки: розетки, 
прочное: порочен, 
нищета: щетина, 
сойти: истой, 
уитмена: уминает, 
атепин: пинает, 
карпенко: накрепко, 
термина: тернами, материн, антриме, 
символичны: сливочными, 
снимает: стенами, 
иголка: логика, 
круга: каргу, 
перст: пестр, сперт, 
огарки: игрока, 
серпы: персы, 
каминг: книгам, 
гришка: гришак, 
прижались: прижилась, 
пожатием: пожимает, 
занимал: заманил, 
кручи: кричу, ручки, 
курси: искру, крису, риску, сурки, 
турки: крути, курит, 
изучала: заучила, 
тундрой: трудной, 
тяжеловата: желтоватая, 
затихла: затихал, 
англия: гнилая, 
сгнила: сигнал, 
столяр: трясло, 
диване: давние, 
санитарная: нарастания, 
могила: логами, 
углами: лугами, 
отпрянув: протянув, 
вражде: держав, 
ендова: надвое, 
наведу: неваду, 
гласит: глиста, 
хвыля: вялых, 
перепонку: покрупнее, 
девать: ведать, 
самураи: мариуса, 
салазки: сказали, 
стрелами: мастерил, 
знаками: заминка, 
упускал: капсулу, 
одобрен: недобро, 
победно: подобен, 
тупик: купит, 
старинным: странными, 
белопенной: побеленной, 
скрип: крисп, 
дешева: давшее, ведаше, 
пучки: кипуч, 
приказа: каприза, 
скатилась: таскались, 
грани: грина, ранги, 
мигая: магия, 
гимна: нагим, 
горами: рогами, 
гасил: гасли, 
гирла: играл, 
гнали: глина, 
мигал: гамли, 
бродячий: добрячий, 
кинга: книга, 
кланом: колман, 
принятыми: приятными, 
лачком: чмокал, 
обоссал: обсосал, 
гриша: гирша, 
обросла: бросало, 
тигра: гатри, 
продана: парадно, 
тоньше: тонешь, 
разница: зарница, 
учтено: ночует, 
сшивать: ставишь, 
стремена: манстере, 
палтус: ступал, спутал, 
задержек: задержке, 
огромны: гормоны, 
уроки: укори, 
трико: ротик, 
копти: топки, 
уступом: пустому, 
исток: косит, стоки, тоски, кости, 
листками: слитками, 
лузга: глазу, 
оживут: животу, 
развод: вздора, здраво, 
оступилась: опустилась, 
пронесли: принесло, 
созвано: сазонов, осознав, 
наврозь: звонарь, 
кануло: клоуна, уклона, окунал, 
струя: труся, 
гроза: розга, 
загон: газон, 
мозга: газом, 
престолом: посмотрел, 
моралите: отмерила, 
манжеты: женатым, 
тонки: ниток, нотки, токин, никто, 
носик: носки, 
корни: норки, 
пинок: поник, 
желавшие: лежавшие, 
ними: мини, 
хили: лихи, 
кинут: нитку, 
лини: нили, 
сикун: сукин, 
чмыкал: лычкам, 
окину: икону, 
стойкости: костистой, 
видано: наводи, 
дивная: видная, 
липнет: плетни, 
давить: видать, 
дожрать: дрожать, 
заперев: везерап, 
хлопка: полках, 
терять: третья, 
щурясь: щурься, 
карлоу: оракул, 
карлос: раскол, 
сопляк: плясок, 
магазинов: гамазинов, 
считанные: станичные, 
оскола: колоса, сокола, 
зоревать: разовьет, 
миску: сумки, 
окружали: окружила, 
мурели: умерли, 
водила: давило, 
увидал: удалив, 
кумир: курим, 
погаси: сапоги, 
иной: йони, 
шиком: мошки, 
мотки: томик, 
косим: иском, 
корми: микро, 
давили: видали, 
комин: конми, 
луки: улик, кули, 
отправится: строптивая, 
коли: кило, 
линк: клин, 
рошели: решило, 
потели: отпели, отлепи, 
пускал: скупал, 
гнета: агент, 
негра: агнер, 
легла: галле, 
ангел: налег, 
игена: гиена, нагие, 
шинелю: лишнею, 
купил: пилку, купли, 
чулки: лукич, 
покойно: окопной, 
линяет: лентяи, 
кучи: чику, чуки, 
стуже: жесту, 
иску: суки, 
эрик: кэри, 
икры: рыки, 
рикс: крис, искр, риск, 
руки: икру, 
крит: трик, 
толки: локти, лотки, 
лисок: кисло, косил, силок, ослик, 
корил: корли, 
копил: полки, липко, 
пику: пуки, кипу, купи, 
икнул: кинул, лунки, 
копи: пико, поки, 
токи: киот, 
соки: кисо, 
кину: нику, 
ломик: ликом, климо, мокли, милок, 
кино: кони, коин, икон, 
нилу: нули, 
нило: олин, 
заболела: облезала, 
миля: мяли, 
лиму: мули, 
мило: моли, илом, 
догма: годам, 
когда: гадок, гадко, 
дагни: гнида, 
глади: гадил, 
получена: уплачено, 
тускло: лоскут, 
логично: личного, 
кишок: кошки, 
июль: илью, 
жрешь: ржешь, 
окрик: корки, 
конки: кокни, 
груда: друга, 
кишку: кукиш, 
одолжить: доложить, 
скуки: куски, 
транса: страна, 
учли: лучи, учил, 
лицу: улиц, 
флит: лифт, 
ился: ясли, сиял, 
клику: лукки, 
комик: комки, 
силы: лисы, 
силу: лису, луис, 
лист: стил, 
оклик: колик, 
лиры: рыли, 
литр: тирл, 
пыли: пилы, 
хлои: лихо, 
любезно: болезню, 
изучали: изучила, 
соли: лоси, слои, 
роли: лори, 
пило: поли, поил, 
пиратом: импорта, тропами, 
причесать: исчерпать, 
мины: ными, иным, 
мину: муни, 
мимо: моим, 
варежке: варежек, 
летним: митнел, 
симнел: сменил, 
бросаться: собраться, 
занявшая: навязшая, 
ссылка: классы, 
бросавшегося: собравшегося, 
юлия: июля, 
россии: осирис, 
соврать: сорвать, 
суярова: суровая, 
цинизма: мизинца, 
билибину: бибилину, 
слепил: сплели, 
мухи: хуми, 
фирм: рифм, 
риму: умри, урим, миру, 
мирт: ритм, 
синь: нись, 
руни: нури, руин, 
близи: бизли, избил, 
носи: осин, сони, сино, сион, 
ослов: слово, волос, 
пошиба: бишопа, 
мидаса: садами, 
дарами: маради, 
работало: отобрала, 
лопатке: потекла, 
габризла: заграбил, 
давления: владения, 
смайтом: таймсом, 
виделась: девались, 
налиты: ланиты, латыни, 
хины: иных, 
сталин: настил, 
лусиан: насилу, сулина, 
терситом: смотрите, 
унию: иную, 
шину: нишу, 
ахнули: ухнали, 
стремилось: смотрелись, 
кларенс: краснел, 
офис: софи, 
ости: сито, 
трои: тори, роти, трио, 
орри: рори, 
счетную: честную, 
оторвались: отворилась, 
заменились: изменилась, 
еланско: оскален, 
похоронены: похоронные, 
мотались: томилась, 
направо: порвана, 
ощипал: пищало, 
тушку: шутку, штуку, 
топила: полита, топали, пилота, питало, отпила, 
описал: пилоса, 
умчался: случаям, 
ослица: социал, 
поручился: проучился, 
ножен: нежно, 
оженю: женою, южное, 
мирных: мрыхин, 
хлюпает: плюхает, 
склада: сладка, 
обеденный: обыденней, 
отпускали: постукали, 
колесам: слокаме, 
мокрела: ермолка, 
коленам: колмена, 
пути: типу, 
хибару: рубахи, 
рекламы: маклеры, 
бирюкам: брюками, 
растер: террас, 
трауре: артуре, 
прикрути: притирку, 
пустить: ступить, 
ставные: вытесан, 
отправились: противилась, 
платьи: палить, 
жеркову: кружево, 
спасли: списал, палисс, 
щупали: пущали, 
ростом: торсом, моторс, тросом, осмотр, 
пришла: шпарил, 
носовой: основой, 
отпросились: построились, 
палицы: пылица, 
дорожек: дорожке, 
топлено: плотное, полноте, 
переступали: переступила, 
фриц: цифр, 
отпроситься: построиться, 
счетных: честных, 
подала: падало, 
тюрасе: старею, 
растет: стерта, 
аресты: старые, 
колоть: локоть, только, 
запертой: трапезой, 
ботаник: ботинка, 
банкиру: рубанки, 
браслетки: браслетик, 
доложите: одолжите, 
противилось: повторились, 
тяжел: ляжет, 
флирта: лифтра, 
утирал: ритуал, 
жулье: ужель, 
старил: стирал, растил, 
занимала: заманила, 
подступить: подпустить, 
ударам: армаду, 
сухи: усих, 
сыти: тисы, 
стих: хист, 
уиттла: титула, 
нестор: строен, 
городов: договор, 
большее: болеешь, 
избивать: избавить, 
ротные: теноры, 
утрате: театру, 
ножке: ножек, 
листая: таился, 
частил: считал, 
стихал: листах, 
сучила: случаи, 
ангелов: главное, 
ложек: ложке, 
ляжек: ляжке, 
желудке: дележку, 
калиновом: волокнами, 
судана: даунса, 
тыщи: щиты, 
советую: тесовую, 
паунда: нападу, 
тишь: шить, 
босоножек: босоножке, 
туши: шути, 
тучи: учти, учит, 
связывал: вызвался, 
хлебные: небелых, 
шалить: лишать, 
женой: ножей, 
отнесу: суетно, устное, 
сотнею: стеною, 
утихла: утихал, 
удивится: увидится, 
шалях: шляха, 
избавили: избивали, 
зельем: земель, 
полдуба: поблуда, 
храмами: махрами, 
сидорин: сордини, 
жокей: кожей, 
строителям: смотрителя, 
передней: перейден, 
иглами: мигали, 
лозунга: заглону, 
ударом: уродам, 
отпустила: отступали, отступила, 
лежит: жилет, лижет, 
трупов: порвут, 
жилке: лежки, 
псалмов: сплавом, 
жених: нихже, 
таловым: вымотал, 
овсов: свово, 
бродили: дробили, 
реалистов: рестовали, 
совершали: совершила, 
хворостинка: новаторских, 
измене: зимнее, 
выступило: выпустило, 
ступили: пустили, 
стряпалась: спряталась, 
приложи: прожили, 
пущено: опущен, 
крутанул: крутнула, 
японец: японце, 
прорвы: прорыв, 
пронес: персон, пресно, 
вычистил: вычислит, 
зимовник: звонкими, 
давлении: владении, 
погостил: постигло, 
занимали: заманили, 
ломбард: рамболд, 
попасть: поспать, 
арабским: бисмарка, 
треской: стройке, 
зрети: зрите, 
стези: тезис, 
струйки: турский, 
робкими: ромбики, 
бокалы: кобыла, 
передел: пределе, 
совать: оставь, 
клумба: клубам, 
слонов: словно, 
леандр: арденл, 
делано: надоел, 
следам: седлам, 
дремал: далмер, 
сделал: седлал, 
спинете: степени, 
делать: дельта, деталь, 
доставила: доставали, 
следах: седлах, 
оправдали: придавало, продавали, 
матросик: стариком, строками, ростками, 
сгорела: согрела, 
покатыми: копытами, 
отступить: отпустить, 
бокалами: облаками, 
стариков: сократив, 
просите: спорите, 
заржал: разжал, 
принятым: приятным, 
зажали: зажила, 
крамбю: брюкам, 
барком: браком, 
приездов: проездив, 
заляпанные: запыленная, 
сообщила: сообщали, 
изрек: резки, 
попортили: протопили, 
сливали: свалили, сивилла, 
капеллан: наклепал, 
говор: рогов, 
правили: прилива, 
плохому: лопухом, 
тропикам: патриком, тропками, 
гуров: гроув, 
шуберт: брешут, 
хребту: бертух, 
крепом: померк, 
реалист: листера, селитра, 
пристыла: пластыри, 
вестового: светового, 
провалить: проливать, 
покоем: помоек, 
бумажке: бумажек, 
мореного: огромное, 
короба: оброка, 
нажали: нажила, 
оправился: воспаряли, 
провались: порвались, 
дорена: народе, ордена, одарен, 
судане: седану, 
ядрена: наряде, андрея, 
раунде: ерунда, аренду, 
андерс: андрес, 
днепра: предан, 
упорно: понуро, 
вернули: ревнули, 
построили: испортило, 
анкилостом: колонистам, 
пара: рапа, 
апаш: паша, 
сана: наса, 
аран: рана, 
анна: нана, 
маас: сама, 
арма: мара, рама, 
мана: нама, 
маха: хама, 
мала: лама, 
скуку: куску, 
арка: рака, кара, акра, 
лака: кала, 
каша: шака, 
така: атак, акта, 
приехал: хрипела, 
лаза: зала, 
тропика: притока, 
берясь: бреясь, 
рада: дара, 
дана: адан, 
адам: дама, 
дага: гада, 
суть: усть, 
дава: авда, 
вала: лава, 
раба: араб, бара, арба, 
бала: алба, 
абак: бака, 
подает: опадет, 
ядерной: ядреной, 
ослепив: повесил, 
провели: привело, поверил, проливе, 
ахат: хата, 
тафа: фата, 
светило: отвесил, осветил, 
мычат: мачты, 
арфа: фара, 
тара: арта, 
раса: арса, 
осмоленной: соломенной, 
раша: шара, 
арбу: рабу, руба, 
рабы: рыба, арбы, 
баян: баня, 
баум: бума, 
была: балы, 
упустив: уступив, 
балу: баул, була, 
курюк: крюку, 
быка: кабы, 
брак: барк, краб, 
обак: бока, 
отвергал: отвергла, 
бука: баку, 
бича: бачи, 
бали: била, 
кабинку: кубанки, 
зуба: базу, 
жиголо: жилого, 
жабо: божа, 
бела: бале, 
бате: бета, 
арбе: баре, 
неба: бане, бена, 
медовый: ведомый, 
баду: дуба, 
дабы: дыба, 
рассекал: рассекла, 
лугов: волгу, углов, 
червона: чернова, 
волго: голов, логов, 
сусам: массу, 
проходив: приходов, 
раздевать: разведать, 
буша: шуба, 
мысах: самых, 
писаны: насыпи, 
туба: табу, 
пустоте: отступе, 
деловой: долевой, 
став: сват, 
обеднел: бледное, 
врат: трав, 
това: авто, 
явна: ваня, 
нова: вона, овна, 
вяла: валя, 
лавы: валы, 
древности: вредности, 
врал: рвал, лавр, 
овал: вола, лова, 
увал: лаву, валу, 
свай: айвс, 
ваши: шива, 
вина: иван, 
сваи: авис, 
ивар: вари, вира, 
язва: вяза, 
вазу: зуав, 
азов: воза, зова, 
разрешат: шартреза, 
веса: васе, сева, 
вера: рева, 
ивад: вида, 
едва: дева, 
гаду: дуга, дагу, гуда, 
сраму: марсу, 
года: дога, 
глад: дагл, 
радует: дарует, 
бродом: бодром, добром, 
добрым: бодрым, 
хмары: храмы, махры, 
вобрало: оборвал, 
корку: курок, 
куско: коксу, кусок, 
сагу: гасу, 
госа: саго, 
гора: рога, арго, 
нога: гона, 
мога: огам, 
англ: гнал, 
угла: луга, угал, гула, 
пруста: спрута, 
величине: влечении, 
гила: лига, игла, 
игра: гари, 
узда: заду, зуда, 
дает: дате, 
даре: адре, 
меда: даем, даме, 
едал: дела, дале, 
дуда: дауд, 
глубин: гибнул, 
духа: худа, 
дачу: чаду, чуда, 
дату: туда, 
поцелуемся: полумесяце, 
конфетку: кофтенку, 
тады: даты, 
сюда: сдаю, 
саду: суда, 
ядра: даря, ряда, ярда, 
руда: удар, уард, дура, 
рады: дары, дыра, 
орда: адор, рода, одра, 
дэна: эдна, 
даны: анды, нады, 
надо: дона, одна, дано, 
дуна: дану, даун, 
дамы: дыма, 
мода: адом, дома, 
даму: дума, 
льда: даль, 
рогатым: грамоты, 
даля: ляда, 
ладу: удал, дула, 
дока: кода, 
прибытие: прибитые, 
придомовой: проводимой, 
дали: дила, 
ауди: аиду, дауи, иуда, 
инда: дани, дина, 
разе: заре, 
заел: зале, 
военная: навеяно, 
грозу: розгу, угроз, 
чертовского: творческого, 
кларенса: краснела, 
моста: томас, 
махор: хрома, 
ротам: морта, 
куком: комку, 
отделаны: отдалены, 
незаменим: знамением, 
роганов: рваного, равного, органов, 
ефта: фате, 
тает: тета, 
чает: чета, 
пастись: списать, 
ладоней: деланой, 
арсе: саре, сера, 
ерша: шаре, 
пера: паре, репа, 
тряпки: прятки, 
пена: пане, 
анне: нена, 
нате: анет, 
низменные: неизменны, 
рена: ране, 
чаем: меча, 
разлетаясь: затерялась, 
низменное: неизменно, 
мена: нема, 
тема: мате, 
амер: маер, мера, раме, арме, 
лена: наел, 
лаем: мела, мале, 
лета: тела, лает, 
леса: села, 
пела: лапе, 
чека: чаек, 
поручу: проучу, 
алек: кале, 
кета: таке, акте, 
река: каре, крае, арке, 
отпирает: потирает, 
сжал: слаж, 
ржал: жрал, 
ложа: жало, 
жука: кажу, 
жила: жали, 
маунт: туман, манту, манут, 
справе: сперва, 
нагнетал: галантен, 
махно: хамон, монах, 
манто: таном, натом, 
сонма: масон, 
норма: роман, 
идейных: ехидный, 
напослед: поднесла, 
неизменна: незнанием, 
каргина: каринга, 
директор: кредитор, 
ослепил: ослепли, поселил, 
сажу: ужас, 
говел: волге, 
сползла: сползал, 
ажур: жару, 
жуан: жану, 
спуски: списку, 
узам: муза, 
свободные: несвободы, 
навсикаи: вакансии, 
заля: злая, 
узла: залу, 
узка: указ, казу, 
зари: рази, риза, 
мази: зима, 
мысам: самым, 
сумам: сумма, 
клейма: майкле, 
стерва: верста, 
остыл: столы, лосты, 
отвергло: торговле, 
известно: вознести, 
шлейфа: шалфей, 
андрее: едрена, 
просят: спорят, потряс, 
страну: струна, 
интереса: растение, 
середа: адресе, 
строением: интересом, 
вороте: второе, 
заря: разя, 
пуза: пауз, 
азот: зато, 
типа: пита, 
пари: рипа, пира, 
наши: ниша, 
тина: тани, 
анис: сани, инса, 
анри: иран, 
миша: маши, 
чрезвычайное: черезвычайно, 
тима: мати, мита, имат, 
мира: мари, рима, 
нами: мина, мани, 
шила: шали, 
таил: итал, 
лиса: сила, 
пила: пали, липа, 
лани: нила, 
мила: мали, 
шика: каши, киша, ишка, 
хаки: иакх, 
кита: кати, таки, тика, итак, 
киса: иска, 
раки: кари, арки, ирак, икра, икар, 
пика: паки, кипа, 
аким: кима, маки, 
икал: кила, 
чмокала: калачом, 
убрус: срубу, 
надеже: жаднее, 
ролях: рохля, 
чтится: чистят, 
покутим: тупиком, 
завидна: издавна, 
задавил: издавал, 
ьдопсог: господь, 
ражден: дренаж, 
таймсе: мастей, 
афиш: фиша, 
тащи: щита, 
ахти: тиха, 
стаи: сита, аист, 
рита: рати, тари, тира, 
арси: сиар, риса, 
сырью: рысью, 
каторгу: курагот, 
найт: тайн, 
ступала: спутала, 
вакансией: навсикаей, 
акой: кайо, 
пухло: лопух, 
толпы: плоты, 
вопроснике: соперников, 
незачем: замечен, 
аргус: гусар, 
комкору: окурком, 
плоту: толпу, 
посля: сопля, 
грози: розги, 
встречное: встречено, 
паскаля: плакася, 
плоду: подул, 
подол: подло, 
врытое: отрыве, вторые, 
уорлд: лорду, 
подлы: плоды, 
ушка: кашу, 
кают: катю, 
отсылка: отыскал, 
утка: тука, акту, 
скат: такс, каст, 
ярка: края, 
фрак: кафр, 
кару: рука, арку, 
карт: крат, трак, 
карр: крра, 
тако: тока, кота, 
сока: коса, 
мука: маку, кума, 
маяк: ямка, 
мрак: марк, 
кома: амок, 
лука: кула, акул, 
ласк: скал, касл, 
карл: крал, 
налетит: антител, 
кока: како, 
задние: здание, 
ездила: задели, 
ласковые: высекало, 
полос: посол, 
ареной: районе, 
приметы: терпимы, 
детища: щадите, 
надавил: наладив, 
неолита: налитое, 
выручка: курчавы, 
рангу: гарун, 
мнемозины: иноземным, 
палочка: покачал, 
посевы: повесы, 
первою: поверю, 
европы: порыве, 
петров: порвет, 
махром: храмом, 
упорные: понурые, 
учла: луча, 
хула: ухал, 
талы: латы, тыла, 
тула: лута, 
ворота: оторва, 
персоны: спорные, 
лапы: палы, пыла, 
лапу: лупа, упал, пула, 
сапл: спал, 
олфа: олаф, 
лаос: осла, сало, лоса, 
орал: орла, лора, 
опал: пола, 
лаун: луна, лану, 
стога: гатос, 
льна: лань, 
горах: рогах, 
поредели: опередил, 
ламу: малу, 
ламы: малы, мыла, алым, 
пришьем: примешь, 
делани: надели, 
делами: медали, 
делали: делила, 
мало: алом, 
наметил: лентами, 
погас: сапог, 
зараженного: зажаренного, 
садике: садкие, адские, 
медика: камеди, 
теслами: сметали, 
струги: грусти, 
шутки: штуки, 
морга: марго, горам, грома, 
донесло: недосол, 
пробил: побрил, 
глянул: лягнул, 
ушам: шума, 
умах: маху, муха, 
мать: тьма, 
мчат: мачт, матч, 
копался: плоская, сопляка, 
пассов: спасов, 
ямса: мяса, 
саму: сума, усам, 
палочку: получка, 
рамы: армы, 
марш: шрам, шарм, 
порыва: оправы, 
ярма: ярам, 
эрам: мэра, 
раму: мура, 
трам: март, 
срам: марс, 
пленила: налепил, 
тонга: гонта, 
гарно: орган, онагр, 
атом: тома, тамо, 
само: сома, 
омар: рома, мора, 
мэна: нэма, 
мона: амон, 
коловшего: шелкового, 
сделай: седлай, 
подавал: подвала, 
дрейфа: фрейда, 
надувал: даванул, 
углах: лугах, 
войском: москвой, 
степу: ступе, 
степь: спеть, 
спеху: успех, 
раздевали: разведали, 
глупа: плуга, пугал, 
гасло: слога, 
нэгла: лэнга, 
нагло: гнало, логан, англо, налог, лонга, 
гнула: лгуна, угнал, 
углам: лугам, 
светоч: счетов, 
советы: высоте, 
совету: устоев, утесов, 
тестов: отсвет, 
австро: створа, 
макбук: кубкам, 
каблук: клубка, 
далеку: укладе, 
складе: сделка, 
приросло: проросли, 
просекой: поскорей, 
хуан: ахну, 
автору: отраву, 
авторы: товары, отвары, 
нэта: энта, 
нута: нату, 
многа: гамно, манго, ногам, 
ханс: снах, 
стан: наст, 
рану: руна, уран, нуар, 
раны: нары, 
замерзла: замерзал, 
откеда: дакоте, 
адское: седока, 
сообразил: забросило, 
тона: нота, нато, 
оная: ояна, 
подорвана: оправдано, 
арно: арон, нора, наро, рано, 
паводка: повадка, 
ленточек: ленточке, 
одном: доном, модно, 
заливе: зевали, завели, 
сунда: судна, 
квелое: клевое, 
раунд: дурна, 
зевало: завело, 
развел: врезал, 
престоле: пестрело, 
владением: давлением, 
травить: втирать, 
погребает: пробегает, 
костных: скотных, 
марком: мраком, 
полежали: пожалели, 
таро: рота, тора, 
роса: сора, 
пасо: оспа, 
оппа: попа, 
свечке: свечек, 
колесник: лексикон, 
мониста: стонами, мастино, 
весами: месива, 
навели: лавине, 
весила: висела, 
валери: верила, ливера, 
хармони: монархи, харимон, 
понимая: поминая, 
салатного: атласного, 
ядрам: рядам, 
валкие: велика, 
навеки: кевина, 
ормонд: родном, 
даром: морда, родам, 
домах: ходам, 
модна: домна, 
оспинам: снопами, 
спокам: компас, 
помогли: пологим, 
катушек: катушке, 
портится: потрясти, 
моторах: хромота, 
завалилась: заливалась, 
краткими: критикам, 
лопаток: потолка, 
кантом: комнат, тканом, танком, 
моркан: краном, 
чудаком: дамочку, 
немыми: мнимые, 
пуха: паху, 
тупа: пату, 
этап: пэта, 
супа: пасу, 
спас: пасс, 
проветрить: претворить, 
прах: храп, 
пупа: папу, 
папы: аппы, 
сотворенные: выстроенное, 
дотла: отдал, 
лорда: драло, 
подал: падло, плода, 
ладно: долан, ландо, 
снимать: сминать, 
сферы: ферсы, 
вертай: тварей, 
ратовалось: оторвалась, 
дышал: дышла, 
воротом: моторов, 
колоде: доколе, 
ладят: дятла, 
полежал: пожалел, пожелал, 
растила: стирала, 
мрачок: рачком, корчма, 
моряка: мокрая, 
комару: урокам, 
мостка: скатом, 
чары: рыча, 
слить: стиль, 
листы: слиты, 
ярах: харя, 
йорк: крой, 
арфы: фары, 
урча: чару, 
арфу: фрау, 
трах: харт, 
тура: раут, тару, утра, 
топором: ропотом, отпором, 
тары: раты, 
расы: сыра, сары, 
силую: юлиус, 
случи: числу, сучил, 
отписали: истопила, 
тонкой: ноткой, 
заслониться: залосниться, 
доска: садок, 
курева: рукаве, 
мрыхина: храмины, 
думка: мудак, 
оклад: клода, лодка, 
уклад: кладу, 
велено: неволе, 
вывалился: выливался, 
душка: дашку, 
сумрак: маркус, 
дырка: кадры, 
дурак: рудка, драку, 
списала: спасали, палисса, 
паралич: причала, 
заперты: запреты, трапезы, 
трапезу: запрету, 
часы: сыча, 
клевал: влекла, 
свалке: свекла, 
суха: усах, хаус, 
саут: уста, 
поклясться: скопляться, 
туша: шута, 
учат: туча, 
фута: фату, 
уатт: тута, 
стреми: смерти, мистер, 
козине: низкое, 
европе: первое, оперев, 
мускат: суткам, кустам, 
нечасто: частное, 
датой: отдай, 
воронами: миронова, 
найду: дунай, 
притих: хрипит, 
поросят: простоя, 
инкубатор: работнику, 
повела: палево, 
пылит: плиты, 
налево: навело, 
лупит: плиту, 
приял: пряли, 
нагрубил: булгарин, 
диска: адски, садки, садик, 
клади: кидал, 
кидай: кадий, 
озлели: елозил, 
верные: венеры, 
венеру: уверен, 
смести: систем, 
ровнее: верное, 
сымите: семиты, 
соколов: волосок, 
сколотого: отголосок, 
спида: аспид, 
трахает: театрах, 
дарил: драли, драил, 
длина: ланди, 
дикая: кадия, кидая, 
олухи: холуи, 
число: сочли, 
задавали: издавала, 
ветрам: мертва, 
стоил: солит, стило, 
бесчестно: бессчетно, 
пилот: отпил, плоти, 
сипло: полис, сопли, 
обтекавший: башковитей, 
сотворили: сиротливо, 
оживила: оживали, 
труть: ртуть, 
реветь: верьте, 
дозах: заход, 
задор: здаро, 
гостем: смогет, 
миноре: мироне, мирное, 
ватные: вынает, 
умения: именуя, 
вилкой: ловкий, 
носил: лисон, 
сменит: снимет, 
равные: рваные, 
январе: верная, 
туой: йоту, 
минуте: минует, уитмен, 
причесывает: исчерпывает, 
оправдаться: продаваться, 
бичом: обчим, 
творческий: чертовский, 
примет: терпим, 
причем: примеч, 
немилой: молнией, молений, 
забежали: избежала, 
жадно: джона, джоан, 
жидам: джима, 
мочил: молчи, 
хилом: лихом, 
ломти: ломит, молит, 
морли: милор, лиром, 
хилым: милых, 
исходным: сходными, 
томите: отмети, 
повеса: посева, 
правое: оправе, европа, 
бабник: бабкин, 
молим: милом, 
ковырял: ярлыков, 
гнетом: ногтем, 
горнем: негром, 
многое: немого, гомоне, 
пожалею: пожелаю, 
полежат: пожалте, 
совета: отсева, 
ревности: верности, 
командах: находкам, 
приказным: капризным, 
любил: блюли, 
ремонтников: терновником, 
обули: убило, 
болит: отбил, 
дрема: драме, 
делал: делла, 
следа: седла, 
детка: кадет, 
далек: ледка, 
далей: делай, 
коленка: наколке, 
всадник: двинска, 
заеду: уезда, 
покидав: повадки, 
казуни: кузина, узника, 
козами: иказом, 
полли: полил, 
приказ: каприз, 
сдает: стаде, стеда, 
молил: ломил, молли, 
среда: адрес, 
уиллс: сулил, 
пылил: плыли, 
андре: арден, недра, 
натирала: таранила, 
бляхи: хляби, 
противен: приветно, 
тревог: отверг, 
отказываю: оказывают, 
кубик: кубки, 
ответила: виолетта, отливает, 
колби: облик, лобик, блоки, 
пробыли: прибыло, 
статуе: устает, 
задавившего: издававшего, 
пожелала: пожалела, 
повидал: допивал, подавил, 
сдавило: сводила, 
входила: охладив, 
прыснул: пырснул, 
пожарные: поражены, 
давился: видался, 
саломони: соломина, 
аккордами: кокардами, 
августа: густава, 
разило: озирал, розали, 
стихам: симхат, 
лазури: разули, 
залило: лизало, 
слизал: слазил, 
терзала: разлета, лазарет, 
рубки: бурки, 
брюки: бирюк, 
пятерки: пятерик, 
изучал: заучил, 
микеле: мелкие, 
залить: лазить, лизать, 
ранена: ренана, 
шептало: потешал, 
выползал: выползла, 
сената: сатане, 
трепало: пролета, отперла, потерла, 
клубок: клобук, 
слепота: слопает, 
сноровки: ворсинок, 
токсинов: сотников, 
подергивал: подвергали, 
постовой: опойство, 
удивила: увидали, 
издохла: заходил, 
понежиться: пожениться, 
вместила: светилам, 
промеж: пожрем, 
матовые: омывает, 
амантов: намотав, 
сможет: жестом, 
слоновод: дословно, 
износа: заноси, 
резаная: нарезая, 
порез: прозе, 
носовые: освоены, 
отвесно: сонетов, 
дописав: посадив, 
просили: спорили, 
путника: антипку, напитку, 
пушинка: пушкина, 
частивший: считавший, 
аботали: обитала, 
напуски: испанку, 
набирал: бранила, набрали, 
востры: вырост, створы, 
тверже: жертве, 
непокорных: покоренных, 
двигало: гадливо, 
розен: зерно, резон, 
щетине: нищете, 
харасе: сахаре, 
предаете: передает, 
сохну: сноху, 
собрались: бросилась, бросались, 
тонус: стону, устно, 
снято: носят, сотня, стоян, 
носют: сотню, 
световым: вестовым, 
стоны: сытно, 
сотника: скотина, токсина, останки, 
ясности: носится, 
ризать: разить, 
трудна: тундра, 
банкира: карабин, 
дурная: наряду, 
трапеза: заперта, запрета, 
венере: вернее, 
автономно: антоновом, 
земно: зноем, 
важнее: невежа, 
притом: импорт, портим, 
спорим: просим, 
говору: уговор, 
творог: торгов, 
горести: строгие, огрести, 
чмокнула: молчанку, 
миронов: норовим, 
зевает: завете, 
завесе: засеве, 
нутро: трону, 
разлада: задрала, 
венера: верена, равнее, 
дворами: дровами, 
входами: вдохами, 
корчажке: корчажек, 
полякова: полковая, 
картинки: критикан, 
ненавидеть: ненавидьте, 
лезут: злует, 
протекала: клеопатра, 
вызовом: вывозом, 
невиданное: наводнение, 
насмешек: насмешке, 
тление: летние, 
каменные: манекены, 
столовка: тосковал, 
ливрее: ревели, 
камешку: макушке, камушек, макушек, 
возвратясь: взорваться, 
смотри: строим, 
протоки: покорит, 
раскину: рисунка, 
каменку: куманек, 
ручника: чукарин, 
испортит: простити, 
островам: матросов, 
кузен: кузне, 
воруют: вторую, 
трясла: стряла, 
резок: резко, 
резвые: вырезе, 
чухался: случаях, 
лизерве: верзиле, 
взлете: влезет, 
вынесения: выяснение, 
резвей: зверей, 
